Date,Kind,Model,Max Mode,Input (w/ Cache Write),Input (w/o Cache Write),Cache Read,Output Tokens,Total Tokens,Cost
"2025-08-30T14:42:15.130Z","Included","auto","No","18626","0","629227","3568","651421","Included"
"2025-08-30T14:32:32.480Z","Included","auto","No","10417","0","210123","2462","223002","Included"
"2025-08-30T14:26:55.857Z","Included","auto","No","28535","0","512217","2725","543477","Included"
"2025-08-30T14:24:54.844Z","Included","auto","No","11558","0","87545","916","100019","Included"
"2025-08-30T14:23:48.099Z","Included","auto","No","11880","0","91305","960","104145","Included"
"2025-08-30T14:22:18.324Z","Included","auto","No","11586","0","132507","1947","146040","Included"
"2025-08-30T14:18:22.803Z","Included","auto","No","19985","0","81344","917","102246","Included"
"2025-08-30T14:15:40.977Z","Included","auto","No","4542","0","227607","1972","234121","Included"
"2025-08-30T14:14:40.158Z","Errored, Not Charged","auto","No","18341","0","143902","2524","164767","Included"
"2025-08-30T14:06:21.623Z","Included","auto","No","0","4996","0","122","5118","Included"
"2025-08-30T14:04:10.879Z","Included","auto","No","0","279","4864","202","5345","Included"
"2025-08-30T14:04:00.580Z","Included","auto","No","0","4913","0","152","5065","Included"
"2025-08-30T13:59:11.075Z","Included","auto","No","5433","0","25040","1537","32010","Included"
"2025-08-30T12:49:35.552Z","Included","auto","No","0","3170","0","319","3489","Included"
"2025-08-30T06:16:39.239Z","Included","auto","No","0","1270","0","26","1296","Included"
"2025-08-30T06:16:30.950Z","Included","auto","No","0","950","0","26","976","Included"
"2025-08-29T15:39:20.571Z","Included","auto","No","0","748","1920","79","2747","Included"
"2025-08-29T15:39:11.783Z","Included","auto","No","0","2658","0","62","2720","Included"
"2025-08-29T15:24:40.212Z","Included","auto","No","6706","0","62162","1390","70258","Included"
"2025-08-29T14:38:15.695Z","Included","auto","No","1316","0","28482","761","30559","Included"
"2025-08-29T14:36:39.355Z","Included","auto","No","5018","0","34705","924","40647","Included"
"2025-08-29T14:35:22.109Z","Included","auto","No","0","982","1920","76","2978","Included"
"2025-08-29T14:32:48.367Z","Included","auto","No","0","2896","0","80","2976","Included"
"2025-08-29T14:07:10.198Z","Included","auto","No","0","213","2816","116","3145","Included"
"2025-08-29T14:06:40.319Z","Included","auto","No","0","2877","0","78","2955","Included"
"2025-08-29T13:14:15.924Z","Included","auto","No","3337","0","16180","583","20100","Included"
"2025-08-29T09:25:11.199Z","Included","auto","No","15255","0","95659","857","111771","Included"
"2025-08-29T09:23:50.776Z","Included","auto","No","6455","0","34167","2085","42707","Included"
"2025-08-28T14:53:09.463Z","Included","auto","No","610","0","15401","391","16402","Included"
"2025-08-28T14:52:25.008Z","Included","auto","No","3555","0","17850","507","21912","Included"
"2025-08-28T14:40:36.896Z","Included","auto","No","0","4885","0","43","4928","Included"
"2025-08-28T12:50:23.733Z","Included","auto","No","19867","0","26841","964","47672","Included"
"2025-08-28T12:37:18.609Z","Included","auto","No","1132","0","43094","672","44898","Included"
"2025-08-28T12:35:23.764Z","Included","auto","No","10710","0","98428","3840","112978","Included"
"2025-08-28T12:33:42.459Z","Included","auto","No","6822","0","20869","1206","28897","Included"
"2025-08-28T11:47:55.428Z","Included","auto","No","0","1687","0","12","1699","Included"
"2025-08-28T11:46:58.548Z","Included","auto","No","0","3677","0","13","3690","Included"
"2025-08-28T11:40:28.477Z","Included","auto","No","8021","0","499122","2513","509656","Included"
"2025-08-28T11:40:17.809Z","Included","auto","No","0","3971","0","20","3991","Included"
"2025-08-28T11:37:56.925Z","Included","auto","No","2403","0","86864","1298","90565","Included"
"2025-08-28T11:31:09.360Z","Included","auto","No","7727","0","96368","2143","106238","Included"
"2025-08-28T11:29:41.135Z","Included","auto","No","1018","0","4249","503","5770","Included"
"2025-08-28T11:29:00.928Z","Included","auto","No","2594","0","8204","774","11572","Included"
"2025-08-28T11:28:14.724Z","Included","auto","No","0","4426","1536","11","5973","Included"
"2025-08-28T11:28:07.848Z","Included","auto","No","0","4315","1536","12","5863","Included"
"2025-08-28T11:26:33.988Z","Included","auto","No","0","5556","0","21","5577","Included"
"2025-08-28T11:25:26.856Z","Included","auto","No","0","678","0","12","690","Included"
"2025-08-28T11:17:57.379Z","Included","auto","No","0","3859","1024","13","4896","Included"
"2025-08-28T11:17:32.385Z","Included","auto","No","688","0","16879","447","18014","Included"
"2025-08-28T11:16:33.942Z","Included","auto","No","0","4982","0","13","4995","Included"
"2025-08-28T11:14:20.449Z","Included","auto","No","0","4451","0","7","4458","Included"
"2025-08-28T11:13:57.605Z","Included","auto","No","0","4303","0","9","4312","Included"
"2025-08-28T11:09:38.829Z","Included","auto","No","12494","0","230750","3386","246630","Included"
"2025-08-28T11:07:54.798Z","Included","auto","No","1349","0","8098","418","9865","Included"
"2025-08-28T08:49:01.608Z","Included","auto","No","0","3336","0","193","3529","Included"
"2025-08-28T08:48:52.473Z","Included","auto","No","0","3174","0","61","3235","Included"
"2025-08-27T15:32:23.210Z","Included","auto","No","6032","0","64034","3050","73116","Included"
"2025-08-27T15:28:49.075Z","Included","auto","No","6441","0","72028","3228","81697","Included"
"2025-08-27T15:18:31.652Z","Included","auto","No","6624","0","79472","2976","89072","Included"
"2025-08-27T15:17:13.563Z","Included","auto","No","0","2743","2048","113","4904","Included"
"2025-08-27T15:17:03.574Z","Included","auto","No","0","4596","0","14","4610","Included"
"2025-08-27T15:16:25.899Z","Included","auto","No","0","2038","2048","14","4100","Included"
"2025-08-27T15:16:15.233Z","Included","auto","No","0","2366","0","13","2379","Included"
"2025-08-27T15:15:34.416Z","Included","auto","No","0","2643","0","14","2657","Included"
"2025-08-27T15:14:23.768Z","Included","auto","No","0","3328","0","24","3352","Included"
"2025-08-27T15:14:06.956Z","Included","auto","No","0","3212","0","24","3236","Included"
"2025-08-27T15:11:54.292Z","Included","auto","No","0","2586","0","12","2598","Included"
"2025-08-27T15:11:24.318Z","Included","auto","No","0","3732","0","13","3745","Included"
"2025-08-27T15:03:18.525Z","Included","auto","No","70349","0","1411334","2751","1484434","Included"
"2025-08-27T14:59:00.418Z","Included","auto","No","5331","0","68444","2684","76459","Included"
"2025-08-27T14:53:26.643Z","Included","auto","No","0","862","0","16","878","Included"
"2025-08-26T15:38:14.293Z","Included","auto","No","714","0","18172","253","19139","Included"
"2025-08-26T15:36:21.662Z","Included","auto","No","4872","0","27790","476","33138","Included"
"2025-08-26T15:16:02.595Z","Included","auto","No","41295","0","390640","1148","433083","Included"
"2025-08-26T13:59:01.920Z","Included","auto","No","0","4635","0","18","4653","Included"
"2025-08-26T13:57:33.457Z","Included","auto","No","4564","0","74859","863","80286","Included"
"2025-08-26T13:20:50.885Z","Errored, Not Charged","auto","No","12021","0","631344","2344","645709","Included"
"2025-08-26T13:18:31.911Z","Included","auto","No","2591","0","43016","922","46529","Included"
"2025-08-26T13:17:47.907Z","Included","auto","No","3600","0","34270","892","38762","Included"
"2025-08-26T13:16:54.236Z","Included","auto","No","2738","0","33916","791","37445","Included"
"2025-08-26T13:16:04.218Z","Included","auto","No","2230","0","15859","828","18917","Included"
"2025-08-26T13:14:43.670Z","Included","auto","No","2703","0","26040","1670","30413","Included"
"2025-08-26T13:13:57.981Z","Included","auto","No","855","0","9207","459","10521","Included"
"2025-08-26T13:13:03.599Z","Included","auto","No","0","2348","2176","9","4533","Included"
"2025-08-26T13:12:38.293Z","Included","auto","No","844","0","9108","344","10296","Included"
"2025-08-26T13:11:31.168Z","Included","auto","No","0","2638","0","8","2646","Included"
"2025-08-26T13:09:18.990Z","Included","auto","No","2721","0","35381","793","38895","Included"
"2025-08-26T13:05:46.595Z","Included","auto","No","0","1533","0","9","1542","Included"
"2025-08-25T15:23:01.382Z","Included","auto","No","10182","0","154507","2586","167275","Included"
"2025-08-25T15:22:24.606Z","Errored, Not Charged","auto","No","0","0","0","0","0","Included"
"2025-08-25T12:07:29.301Z","Included","auto","No","0","2468","0","27","2495","Included"
"2025-08-25T12:02:29.929Z","Included","auto","No","7699","0","113035","1716","122450","Included"
"2025-08-25T11:52:44.283Z","Included","auto","No","2458","0","13578","1211","17247","Included"
"2025-08-25T11:40:08.829Z","Included","auto","No","1840","0","88859","486","91185","Included"
"2025-08-25T11:38:27.400Z","Included","auto","No","4911","0","46168","2482","53561","Included"
"2025-08-24T15:42:48.910Z","Included","auto","No","18798","0","161687","1340","181825","Included"
"2025-08-24T14:07:48.900Z","Included","auto","No","27873","0","248072","1609","277554","Included"
"2025-08-24T13:47:38.660Z","Errored, Not Charged","auto","No","5739","0","52091","663","58493","Included"
"2025-08-24T13:01:28.534Z","Included","auto","No","11877","0","239022","2841","253740","Included"
"2025-08-24T12:50:07.411Z","Included","auto","No","19443","0","163689","1681","184813","Included"
"2025-08-24T12:41:00.982Z","Errored, Not Charged","auto","No","22901","0","417205","4358","444464","Included"
"2025-08-24T12:22:00.714Z","Included","auto","No","2905","0","123422","961","127288","Included"
"2025-08-24T12:17:15.030Z","Errored, Not Charged","auto","No","15188","0","1073241","5435","1093864","Included"
"2025-08-24T10:33:09.723Z","Errored, Not Charged","auto","No","6486","0","56685","524","63695","Included"
"2025-08-24T09:13:34.915Z","Included","auto","No","88957","0","1733965","2666","1825588","Included"
"2025-08-24T09:01:01.657Z","Included","auto","No","37966","0","289268","2363","329597","Included"
"2025-08-23T15:36:39.361Z","Included","auto","No","4447","0","33081","734","38262","Included"
"2025-08-23T15:16:45.517Z","Included","auto","No","0","2845","0","77","2922","Included"
