Date,Kind,Model,Max Mode,Input (w/ Cache Write),Input (w/o Cache Write),Cache Read,Output Tokens,Total Tokens,Cost
2025-10-07T14:40:27.939Z,Included,auto,No,466712,4227,195083,3859,669881,0.66
2025-10-07T14:31:12.320Z,Included,auto,No,0,196,1536,97,1829,0.001
2025-10-07T14:30:58.888Z,Included,auto,No,0,1548,0,69,1617,0.002
2025-10-07T14:28:46.479Z,Included,auto,No,44329,3620,106126,1642,155717,0.10
2025-10-07T14:20:07.993Z,"Errored, Not Charged",auto,No,45223,22226,159515,9360,236324,0.18
2025-10-07T14:20:05.650Z,Included,auto,No,61120,9997,107627,9999,188743,0.18
2025-10-07T14:13:24.697Z,Included,auto,No,29735,3473,36825,2376,72409,0.06
2025-10-07T14:12:32.919Z,Included,auto,No,23719,808,20971,1142,46640,0.04
2025-10-07T14:06:17.320Z,Included,auto,No,50970,9125,54978,8598,123671,0.14
2025-10-07T13:47:38.259Z,Included,auto,No,33217,10150,54158,7737,105262,0.11
2025-10-07T13:46:09.088Z,"Errored, Not Charged",auto,No,202764,39366,257391,16197,515718,0.46
2025-10-07T13:44:50.839Z,Included,auto,No,92872,27128,99835,8307,228142,0.22
2025-10-07T13:34:17.248Z,Included,auto,No,2504,1971,108180,626,113281,0.04
2025-10-07T13:33:32.571Z,Included,auto,No,25477,690,45806,991,72964,0.05
2025-10-07T13:26:07.998Z,Included,auto,No,33538,41766,327398,5116,407818,0.21
2025-10-07T13:23:01.434Z,Included,auto,No,32799,52654,286139,4929,376521,0.21
2025-10-07T12:57:22.715Z,Included,auto,No,19325,8400,64424,7181,99330,0.09
2025-10-07T12:56:06.952Z,Included,auto,No,60332,22559,93839,8912,185642,0.18
2025-10-07T12:55:32.782Z,Included,auto,No,83669,14346,108479,12413,218907,0.22
2025-10-07T12:54:57.249Z,Included,auto,No,67508,9370,23889,10108,110875,0.16
2025-10-07T12:15:51.993Z,Included,auto,No,0,3370,0,10,3380,0.004
2025-10-06T15:51:10.816Z,Included,auto,No,13073,271,44436,5139,62919,0.06
2025-10-06T15:50:38.643Z,Included,auto,No,17987,459,160452,4820,183718,0.09
2025-10-06T15:50:06.358Z,Included,auto,No,30800,453,240582,5041,276876,0.13
2025-10-05T16:03:50.752Z,Included,auto,No,0,903,0,43,946,0.001
2025-10-05T15:59:34.648Z,Included,auto,No,0,702,1024,16,1742,0.001
2025-10-05T15:59:22.780Z,Included,auto,No,0,1236,0,26,1262,0.002
2025-10-05T15:59:08.959Z,Included,auto,No,0,1161,0,8,1169,0.001
2025-10-05T15:58:25.881Z,Included,auto,No,0,1221,0,12,1233,0.002
2025-10-05T15:56:49.946Z,Included,auto,No,0,1029,0,30,1059,0.001
2025-10-05T15:55:27.041Z,Included,auto,No,0,895,0,41,936,0.001
2025-10-05T15:48:03.234Z,Included,auto,No,51841,0,259858,8136,319835,0.18
2025-10-05T15:47:01.654Z,Included,auto,No,15458,0,311802,5239,332499,0.13
2025-10-05T15:46:41.438Z,Included,auto,No,18065,0,377505,4602,400172,0.14
2025-10-05T15:46:17.910Z,Included,auto,No,31805,0,414266,4675,450746,0.17
2025-10-05T15:31:36.235Z,Included,auto,No,60080,0,1160367,8462,1228909,0.42
2025-10-05T15:28:08.998Z,Included,auto,No,52481,0,386487,3571,442539,0.18
2025-10-05T14:36:34.843Z,Included,auto,No,13279,58610,1331551,4592,1408032,0.45
2025-10-05T14:34:43.956Z,Included,auto,No,49356,0,282244,557,332157,0.14
2025-10-05T14:08:43.659Z,Included,auto,No,6392,0,53250,2193,61835,0.03
2025-10-05T14:03:03.215Z,Included,auto,No,9458,0,139666,2785,151909,0.06
2025-10-05T12:02:21.071Z,Included,auto,No,0,2884,0,10,2894,0.004
2025-10-05T12:01:14.056Z,Included,auto,No,0,1789,0,10,1799,0.002
2025-10-04T14:23:27.170Z,Included,auto,No,4657,0,22054,506,27217,0.01
2025-10-04T14:18:09.936Z,Included,auto,No,3931,0,21382,384,25697,0.01
2025-10-04T14:17:47.059Z,Included,auto,No,2771,0,20498,221,23490,0.01
2025-10-04T14:17:21.427Z,Included,auto,No,2341,5092,26743,324,34500,0.02
2025-10-04T14:16:26.654Z,Included,auto,No,5346,0,39070,1345,45761,0.02
2025-10-04T14:06:07.416Z,Included,auto,No,6512,0,86064,2579,95155,0.05
2025-10-04T12:55:36.524Z,Included,auto,No,814,0,18391,416,19621,0.01
2025-10-04T12:54:24.070Z,Included,auto,No,855,4397,24438,196,29886,0.01
2025-10-04T12:52:00.813Z,Included,auto,No,4806,0,18762,327,23895,0.01
2025-10-04T10:24:36.035Z,Included,auto,No,0,3560,0,12,3572,0.005
2025-10-04T10:23:46.363Z,Included,auto,No,0,2412,0,12,2424,0.003
2025-10-04T10:22:25.382Z,Included,auto,No,0,1128,0,12,1140,0.001
2025-10-04T10:22:13.436Z,Included,auto,No,0,1026,0,10,1036,0.001
2025-10-02T14:29:11.290Z,Included,auto,No,0,1666,0,25,1691,0.002
2025-10-02T14:29:02.138Z,Included,auto,No,0,1566,0,8,1574,0.002
2025-10-02T14:26:09.965Z,Included,auto,No,0,1588,0,14,1602,0.002
2025-10-02T14:04:58.674Z,Included,auto,No,0,1583,0,14,1597,0.002
2025-10-01T16:12:41.245Z,Included,auto,No,9380,0,100864,1570,111814,0.05
2025-10-01T15:13:01.455Z,Included,auto,No,0,1999,0,283,2282,0.004
2025-10-01T15:10:14.861Z,Included,auto,No,0,1904,0,268,2172,0.004
2025-09-30T16:12:17.010Z,Included,auto,No,5081,0,156977,1701,163759,0.06
2025-09-30T16:11:14.473Z,Included,auto,No,5014,0,132974,1657,139645,0.05
2025-09-30T16:09:14.666Z,Included,auto,No,5945,0,89086,1296,96327,0.04
2025-09-30T16:04:44.385Z,Included,auto,No,25755,0,1267907,6729,1300391,0.39
2025-09-30T16:04:04.045Z,Included,auto,No,18267,0,19961,677,38905,0.03
2025-09-30T15:45:06.377Z,Included,auto,No,56064,0,1540608,10151,1606823,0.52
2025-09-30T15:16:47.568Z,Included,auto,No,182805,27138,1275772,4788,1490503,0.61
2025-09-30T15:01:19.584Z,Included,auto,No,17156,0,66304,527,83987,0.04
2025-09-30T14:53:14.828Z,Included,auto,No,32463,0,571392,1459,605314,0.19
2025-09-30T14:48:41.543Z,Included,auto,No,17206,0,83286,738,101230,0.05
2025-09-30T14:45:38.468Z,Included,auto,No,28621,0,320000,1468,350089,0.12
2025-09-30T14:32:55.516Z,Included,auto,No,29701,0,1783040,2251,1814992,0.50
2025-09-30T14:30:36.729Z,Included,auto,No,28255,0,109056,446,137757,0.07
2025-09-30T14:19:47.759Z,Included,auto,No,45463,0,848128,2621,896212,0.28
2025-09-30T14:05:29.561Z,Included,auto,No,80837,0,1220864,3847,1305548,0.43
2025-09-30T13:49:08.972Z,Included,auto,No,41145,0,985018,5557,1031720,0.33
2025-09-30T13:02:06.596Z,Included,auto,No,25883,0,423459,6255,455597,0.18
2025-09-30T12:55:54.086Z,Included,auto,No,17448,0,79635,598,97681,0.05
2025-09-30T12:34:36.647Z,Included,auto,No,1720,0,20736,606,23062,0.01
2025-09-30T12:26:39.454Z,Included,auto,No,3224,0,20992,1340,25556,0.02
2025-09-30T12:24:17.402Z,Included,auto,No,10482,0,35328,2144,47954,0.03
2025-09-29T16:23:06.574Z,Included,auto,No,14111,0,216320,2166,232597,0.08
2025-09-29T16:19:52.817Z,Included,auto,No,1177,649,44063,481,46370,0.02
2025-09-29T16:19:22.710Z,Included,auto,No,1602,389,39661,865,42517,0.02
2025-09-29T16:18:23.535Z,Included,auto,No,2978,264,56019,1365,60626,0.03
2025-09-29T16:17:24.666Z,Included,auto,No,8423,0,114881,1550,124854,0.05
2025-09-29T15:59:55.492Z,Included,auto,No,16285,0,998912,1131,1016328,0.28
2025-09-29T15:53:28.956Z,Included,auto,No,84324,0,870656,978,955958,0.33
2025-09-29T15:46:43.192Z,Included,auto,No,75808,0,791040,1608,868456,0.30
2025-09-29T15:28:51.648Z,Included,auto,No,0,7876,0,16,7892,0.01
2025-09-29T15:21:57.995Z,Included,auto,No,6839,0,67840,824,75503,0.03
2025-09-28T15:54:34.648Z,Included,auto,No,2538,0,30550,346,33434,0.01
2025-09-28T15:53:46.040Z,Included,auto,No,774,0,19969,158,20901,0.01
2025-09-28T15:52:21.874Z,Included,auto,No,4654,0,29900,433,34987,0.02
2025-09-28T15:50:00.899Z,Included,auto,No,2076,0,31488,368,33932,0.01
2025-09-28T15:49:47.961Z,"Errored, Not Charged",auto,No,611,0,9472,57,10140,0.003
2025-09-28T15:37:57.244Z,Included,auto,No,0,6499,0,102,6601,0.01
2025-09-28T15:35:14.949Z,Included,auto,No,58582,0,156672,1134,216388,0.12
2025-09-28T15:33:51.890Z,Included,auto,No,59828,0,136960,1092,197880,0.12
2025-09-28T14:36:25.868Z,Included,auto,No,8871,0,66048,2527,77446,0.04
2025-09-28T14:33:50.454Z,Included,auto,No,9624,0,36096,1758,47478,0.03
2025-09-28T14:25:52.746Z,Included,auto,No,23407,0,68352,886,92645,0.05
2025-09-28T14:24:22.873Z,Included,auto,No,30582,0,206336,2889,239807,0.11
2025-09-28T14:21:40.460Z,Included,auto,No,25738,0,120873,1470,148081,0.07
2025-09-28T14:19:36.265Z,Included,auto,No,25938,0,126720,3209,155867,0.08
2025-09-28T14:15:50.113Z,Included,auto,No,2171,0,20736,168,23075,0.01
2025-09-28T14:14:42.733Z,Included,auto,No,3527,0,41216,1128,45871,0.02
2025-09-28T14:12:12.293Z,Included,auto,No,51526,0,114688,3208,169422,0.11
2025-09-28T14:09:31.602Z,Included,auto,No,3199,0,36352,1087,40638,0.02
2025-09-28T14:08:15.543Z,Included,auto,No,4196,0,39680,1256,45132,0.02
2025-09-28T14:07:19.663Z,Included,auto,No,3289,0,51200,1111,55600,0.02
2025-09-28T14:02:19.108Z,Included,auto,No,9159,0,34560,1124,44843,0.03
2025-09-28T12:56:42.697Z,Included,auto,No,31251,0,606208,881,638340,0.20
2025-09-28T12:53:51.132Z,Included,auto,No,52002,0,117760,2666,172428,0.11
2025-09-27T15:01:20.697Z,Included,auto,No,0,1653,0,13,1666,0.002
2025-09-25T16:03:29.014Z,Included,auto,No,8782,0,150272,2630,161684,0.06
2025-09-25T16:02:42.787Z,Included,auto,No,8084,0,24320,279,32683,0.02
2025-09-25T15:58:05.742Z,Included,auto,No,10011,0,26368,416,36795,0.02
2025-09-25T15:50:05.082Z,Included,auto,No,8782,0,36864,561,46207,0.02
2025-09-25T15:48:08.674Z,Included,auto,No,12258,0,56832,2957,72047,0.05
2025-09-25T15:44:30.184Z,Included,auto,No,19509,0,274176,2863,296548,0.11
2025-09-23T16:07:39.439Z,Included,auto,No,6136,0,54528,2115,62779,0.03
2025-09-23T15:59:35.578Z,Included,auto,No,7092,0,107776,129,114997,0.04
2025-09-23T15:50:35.320Z,Included,auto,No,73010,0,244736,2404,320150,0.17
2025-09-23T15:49:13.115Z,Included,auto,No,48886,0,61440,1805,112131,0.09
2025-09-23T15:23:04.694Z,Included,auto,No,18715,0,140288,3470,162473,0.08
2025-09-23T15:19:38.919Z,Included,auto,No,24671,0,404224,3452,432347,0.15
2025-09-23T15:19:33.089Z,Included,auto,No,29432,0,547072,3478,579982,0.19
2025-09-23T15:19:15.525Z,Included,auto,No,23125,0,323328,3155,349608,0.13
2025-09-23T15:17:39.614Z,Included,auto,No,22556,0,228352,4009,254917,0.11
2025-09-23T15:15:25.103Z,Included,auto,No,21811,0,286725,4076,312612,0.12
2025-09-23T15:14:45.497Z,Included,auto,No,26907,0,253440,10545,290892,0.16
2025-09-23T15:14:14.022Z,Included,auto,No,24014,0,164289,5560,193863,0.10
2025-09-23T15:12:57.775Z,Included,auto,No,30558,0,340736,6214,377508,0.16
2025-09-23T14:58:48.113Z,Included,auto,No,30323,0,428288,3700,462311,0.17
2025-09-23T14:57:54.901Z,Included,auto,No,36477,0,271104,4881,312462,0.14
2025-09-23T14:52:15.275Z,Included,auto,No,6068,0,21504,140,27712,0.01
2025-09-23T14:48:21.611Z,Included,auto,No,52792,0,347117,4679,404588,0.18
2025-09-23T14:38:57.688Z,Included,auto,No,42622,0,395776,4181,442579,0.18
2025-09-22T15:07:06.782Z,Included,auto,No,700,0,22974,226,23900,0.01
2025-09-22T15:06:27.527Z,Included,auto,No,719,0,21574,210,22503,0.01
2025-09-22T15:06:06.889Z,Included,auto,No,885,0,20003,210,21098,0.01
2025-09-22T15:05:40.000Z,Included,auto,No,2678,0,16564,203,19445,0.01
2025-09-22T15:01:39.837Z,Included,auto,No,2190,0,17304,377,19871,0.01
2025-09-22T14:51:21.521Z,Included,auto,No,189843,0,6618048,7822,6815713,1.94
2025-09-22T14:42:16.956Z,Included,auto,No,47565,0,1413011,2446,1463022,0.43
2025-09-22T14:35:27.495Z,"Errored, Not Charged",auto,No,50841,0,1789109,2680,1842630,0.53
2025-09-22T14:27:33.915Z,Included,auto,No,2693,0,56702,1305,60700,0.03
2025-09-22T14:25:50.939Z,Included,auto,No,1732,0,35936,1043,38711,0.02
2025-09-22T14:23:53.502Z,Included,auto,No,4338,0,45683,1255,51276,0.02
2025-09-22T14:15:03.451Z,Included,auto,No,2988,0,16300,607,19895,0.01
2025-09-22T14:07:13.123Z,Included,auto,No,2775,0,16256,455,19486,0.01
2025-09-22T13:54:01.576Z,Included,auto,No,8129,0,560883,2876,571888,0.17
2025-09-22T13:51:14.785Z,Included,auto,No,6814,0,142192,1512,150518,0.05
2025-09-22T13:49:37.401Z,Included,auto,No,3509,0,36282,751,40542,0.02
2025-09-22T13:14:55.615Z,Included,auto,No,0,2000,0,134,2134,0.003
2025-09-22T13:12:22.800Z,Included,auto,No,1991,0,54237,1400,57628,0.02
2025-09-22T13:10:34.419Z,Included,auto,No,4940,0,39825,2907,47672,0.03
2025-09-22T13:00:11.801Z,Included,auto,No,2928,0,89198,1515,93641,0.04
2025-09-22T12:57:57.126Z,Included,auto,No,6590,0,100166,2366,109122,0.05
2025-09-22T12:55:23.673Z,Included,auto,No,0,1626,0,17,1643,0.002
2025-09-22T12:54:14.065Z,Included,auto,No,1948,0,42584,749,45281,0.02
2025-09-22T12:52:44.171Z,Included,auto,No,5732,0,78357,2071,86160,0.04
2025-09-22T12:46:20.950Z,Included,auto,No,7883,0,141316,1943,151142,0.06
2025-09-22T12:27:34.530Z,Included,auto,No,13410,0,125432,3706,142548,0.07
2025-09-22T12:25:14.810Z,Included,auto,No,7954,0,31495,3686,43135,0.04
2025-09-22T12:21:11.785Z,Included,auto,No,44017,0,149935,2285,196237,0.11
2025-09-21T15:20:22.868Z,Included,auto,No,224770,110,16306628,32605,16564113,4.55
2025-09-21T15:15:19.814Z,Included,auto,No,169915,12,725575,913,896415,0.40
2025-09-21T15:13:54.916Z,Included,auto,No,9271,14,70338,777,80400,0.03
2025-09-21T15:13:02.905Z,Included,auto,No,11737,14,77767,726,90244,0.04
2025-09-21T15:12:16.002Z,Included,auto,No,7939,0,22170,253,30362,0.02
2025-09-20T13:45:40.237Z,Included,auto,No,24311,30,150897,4125,179363,0.09
2025-09-20T13:39:57.260Z,Included,auto,No,0,4543,0,81,4624,0.01
2025-09-20T13:36:48.455Z,Included,auto,No,24795,0,218928,2286,246009,0.10
2025-09-20T13:25:19.386Z,Included,auto,No,44859,54,410881,6863,462657,0.20
2025-09-20T09:55:09.856Z,Included,auto,No,0,3345,0,25,3370,0.004
2025-09-19T15:55:58.114Z,Included,auto,No,0,6749,0,37,6786,0.01
2025-09-19T15:52:16.241Z,Included,auto,No,26169,12,66459,3483,96123,0.07
2025-09-19T15:41:49.796Z,Included,auto,No,0,3127,0,14,3141,0.004
2025-09-19T15:36:07.334Z,Included,auto,No,0,1303,0,12,1315,0.002
2025-09-19T15:34:13.682Z,Included,auto,No,4172,14,53720,1051,58957,0.02
2025-09-19T15:33:09.942Z,Included,auto,No,0,2256,0,14,2270,0.003
2025-09-19T15:28:00.249Z,Included,auto,No,0,1210,0,7,1217,0.002
2025-09-19T15:16:34.287Z,Included,auto,No,4270,2,10922,622,15816,0.01
2025-09-19T15:15:14.400Z,Included,auto,No,0,1931,0,15,1946,0.003
2025-09-19T15:03:50.289Z,Included,auto,No,781,304,12612,553,14250,0.01
2025-09-19T15:03:20.429Z,Included,auto,No,1690,263,10922,521,13396,0.01
2025-09-18T15:48:12.677Z,Included,auto,No,25251,0,203889,3075,232215,0.10
2025-09-18T15:41:43.195Z,Included,auto,No,9169,14,63111,1925,74219,0.04
2025-09-18T15:28:46.128Z,Included,auto,No,24966,37,175364,4367,204734,0.10
2025-09-18T14:53:59.149Z,Included,auto,No,9966,0,156936,2023,168925,0.06
2025-09-18T14:48:05.993Z,Included,auto,No,40239,12,482549,2861,525661,0.19
2025-09-18T14:42:13.043Z,Included,auto,No,88953,7269,201148,1299,298669,0.18
2025-09-18T14:34:15.256Z,Included,auto,No,18853,6640,1591728,4536,1621757,0.46
2025-09-18T14:30:48.317Z,Included,auto,No,3245,645,136900,1739,142529,0.05
2025-09-18T14:29:47.498Z,Included,auto,No,2200,570,132500,1051,136321,0.04
2025-09-18T14:28:38.830Z,Included,auto,No,7484,475,182131,1211,191301,0.06
2025-09-18T14:26:21.211Z,Included,auto,No,4483,1562,223308,1721,231074,0.07
2025-09-18T14:24:05.459Z,Included,auto,No,6121,1508,198525,2530,208684,0.07
2025-09-18T14:22:29.940Z,Included,auto,No,7566,2969,175381,2778,188694,0.07
2025-09-18T14:21:06.163Z,Included,auto,No,6236,2630,146558,2210,157634,0.06
2025-09-18T14:19:52.272Z,Included,auto,No,4608,795,91330,2052,98785,0.04
2025-09-18T14:16:06.308Z,Included,auto,No,18670,24,321548,7072,347314,0.15
2025-09-18T14:10:46.602Z,Included,auto,No,5074,568,249325,2566,257533,0.08
2025-09-18T14:08:06.620Z,Included,auto,No,8719,55,559055,4116,571945,0.18
2025-09-18T14:05:47.321Z,Included,auto,No,11653,2204,332620,5086,351563,0.13
2025-09-18T14:03:15.671Z,Included,auto,No,16586,522,115237,1488,133833,0.06
2025-09-18T13:50:51.117Z,Included,auto,No,13200,17,218445,6567,238229,0.11
2025-09-18T13:44:36.534Z,Included,auto,No,21634,17,355520,7251,384422,0.16
2025-09-18T12:58:22.347Z,Included,auto,No,19886,302,1315009,3639,1338836,0.38
2025-09-18T12:53:09.372Z,Included,auto,No,40907,18,621474,6855,669254,0.25
2025-09-18T12:33:08.119Z,Included,auto,No,187079,26,2681411,6226,2874742,0.94
2025-09-18T12:29:16.042Z,Included,auto,No,184376,13,2654574,7245,2846208,0.94
2025-09-18T12:25:09.704Z,Included,auto,No,185146,31,2617488,7433,2810098,0.93
2025-09-18T12:22:07.089Z,"Errored, Not Charged",auto,No,4131,381,220684,1418,226614,0.07
2025-09-18T12:18:08.442Z,Included,auto,No,14877,17,224497,5690,245081,0.11
2025-09-18T12:14:31.664Z,Included,auto,No,0,1778,2688,15,4481,0.003
2025-09-18T12:14:17.772Z,Included,auto,No,0,1895,2560,9,4464,0.003
2025-09-18T12:14:09.196Z,Included,auto,No,0,1897,2432,9,4338,0.003
2025-09-18T12:13:52.320Z,Included,auto,No,0,4194,0,9,4203,0.01
2025-09-18T09:28:09.177Z,Included,auto,No,0,2577,0,73,2650,0.004
2025-09-17T14:56:35.885Z,Included,auto,No,31034,30,138487,5482,175033,0.11
2025-09-17T14:43:10.823Z,Included,auto,No,27297,30,245890,5391,278608,0.13
2025-09-17T14:21:46.040Z,Included,auto,No,45609,51,563220,8372,617252,0.25
2025-09-17T14:11:24.914Z,Included,auto,No,35257,545,1005250,5310,1046362,0.33
2025-09-17T14:04:58.386Z,Included,auto,No,15787,12,195997,4400,216196,0.10
2025-09-17T13:56:36.896Z,"Errored, Not Charged",auto,No,56778,19,1867328,7284,1931409,0.58
2025-09-17T13:45:41.920Z,Included,auto,No,34709,35,238019,6073,278836,0.14
2025-09-17T13:09:07.285Z,Included,auto,No,10059,11,45155,1451,56676,0.03
2025-09-17T12:27:29.734Z,Included,auto,No,0,412,2176,31,2619,0.001
2025-09-17T12:27:16.784Z,Included,auto,No,0,2460,0,28,2488,0.003
2025-09-16T15:19:49.186Z,Included,auto,No,36874,0,803985,6397,847256,0.29
2025-09-16T15:17:57.961Z,Included,auto,No,12558,0,82114,3259,97931,0.06
2025-09-16T15:07:08.192Z,Included,auto,No,6683,0,17087,425,24195,0.02
2025-09-16T14:55:43.771Z,Included,auto,No,19831,0,237523,2211,259565,0.10
2025-09-16T14:52:10.963Z,Included,auto,No,11128,0,208749,1921,221798,0.08
2025-09-16T12:26:44.817Z,Included,auto,No,23911,0,189171,2225,215307,0.09
2025-09-16T12:25:02.120Z,Included,auto,No,10312,0,54870,1434,66616,0.04
2025-09-16T12:08:27.946Z,Included,auto,No,9375,0,2220892,3171,2233438,0.59
2025-09-16T12:06:28.771Z,Included,auto,No,54610,0,638165,1622,694397,0.24
2025-09-16T12:04:30.669Z,Included,auto,No,5094,0,736931,2566,744591,0.21
2025-09-16T12:02:57.229Z,Included,auto,No,6376,0,529163,1758,537297,0.15
2025-09-16T12:00:57.266Z,Included,auto,No,15876,0,371014,1069,387959,0.12
2025-09-16T11:58:34.163Z,Included,auto,No,33702,0,471136,3849,508687,0.18
2025-09-16T11:55:22.541Z,Included,auto,No,15429,0,94129,877,110435,0.05
2025-09-16T11:47:42.915Z,Included,auto,No,2159,0,401378,738,404275,0.11
2025-09-16T11:45:03.902Z,Included,auto,No,16239,0,853141,3810,873190,0.26
2025-09-16T11:42:01.494Z,Included,auto,No,32990,0,951864,3560,988414,0.30
2025-09-16T11:31:57.037Z,Included,auto,No,21370,0,176357,5195,202922,0.10
2025-09-16T11:27:56.160Z,Included,auto,No,6130,0,173863,3524,183517,0.07
2025-09-16T11:24:05.508Z,Included,auto,No,17943,0,103730,3040,124713,0.07
2025-09-16T11:19:19.859Z,Included,auto,No,17443,0,77043,2764,97250,0.06
2025-09-16T11:14:45.606Z,Included,auto,No,20183,0,213491,3753,237427,0.10
2025-09-16T11:10:32.185Z,Included,auto,No,4151,0,536419,1482,542052,0.15
2025-09-16T11:06:58.963Z,Included,auto,No,40598,0,406099,2205,448902,0.17
2025-09-16T11:06:23.180Z,Included,auto,No,1076,0,84630,607,86313,0.03
2025-09-16T11:06:07.797Z,"Errored, Not Charged",auto,No,0,0,0,0,0,0.00
2025-09-16T11:04:12.683Z,Included,auto,No,3201,0,199479,1553,204233,0.06
2025-09-16T11:01:11.784Z,Included,auto,No,31397,0,609366,2834,643597,0.21
2025-09-16T10:07:23.443Z,Included,auto,No,19650,0,119830,4307,143787,0.08
2025-09-16T09:54:29.946Z,Included,auto,No,7528,0,478172,3776,489476,0.15
2025-09-16T09:50:07.996Z,Included,auto,No,34229,0,557501,8621,600351,0.23
2025-09-16T09:45:23.839Z,Included,auto,No,14353,0,318395,2828,335576,0.11
2025-09-16T09:38:38.435Z,Included,auto,No,19260,0,177630,6021,202911,0.10
2025-09-16T09:28:46.307Z,Included,auto,No,32969,0,462595,16006,511570,0.25
2025-09-16T09:23:01.871Z,Included,auto,No,34293,0,483761,4921,522975,0.19
2025-09-16T09:00:27.621Z,Included,auto,No,53643,0,863878,5650,923171,0.32
2025-09-16T07:23:22.181Z,Included,auto,No,42694,0,632024,9802,684520,0.27
2025-09-16T07:12:24.160Z,Included,auto,No,21496,0,298186,3395,323077,0.12
2025-09-16T07:09:47.193Z,Included,auto,No,10665,0,85659,2084,98408,0.05
2025-09-16T06:10:31.558Z,Included,auto,No,0,1351,0,17,1368,0.002
2025-09-16T06:00:09.677Z,Included,auto,No,0,1578,0,19,1597,0.002
2025-09-15T13:57:20.545Z,Included,auto,No,0,6391,0,50,6441,0.01
2025-09-15T13:57:09.696Z,Included,auto,No,0,6523,0,180,6703,0.01
2025-09-15T13:56:48.945Z,Included,auto,No,0,1701,0,122,1823,0.004
2025-09-15T13:50:56.975Z,Included,auto,No,0,6392,0,139,6531,0.01
2025-09-14T15:47:41.062Z,Included,auto,No,39538,0,287728,4403,331669,0.13
2025-09-14T15:13:52.873Z,Included,auto,No,1224,0,39711,199,41134,0.01
2025-09-14T15:13:31.792Z,Included,auto,No,9791,0,28778,174,38743,0.02
2025-09-14T15:12:55.772Z,Included,auto,No,1901,0,99524,534,101959,0.03
2025-09-14T15:12:35.235Z,Included,auto,No,6059,0,40245,234,46538,0.02
2025-09-14T15:11:50.032Z,Included,auto,No,1571,0,100021,390,101982,0.03
2025-09-14T15:11:31.156Z,Included,auto,No,1373,0,46535,303,48211,0.01
2025-09-14T15:11:17.292Z,Included,auto,No,4043,0,41440,111,45594,0.01
2025-09-14T15:10:47.176Z,Included,auto,No,1972,0,35318,171,37461,0.01
2025-09-14T15:10:18.775Z,Included,auto,No,7991,0,60165,626,68782,0.03
2025-09-14T15:02:32.633Z,Included,auto,No,1336,0,29095,250,30681,0.01
2025-09-14T15:01:43.018Z,Included,auto,No,6859,0,20780,349,27988,0.01
2025-09-14T14:16:38.828Z,Included,auto,No,27913,0,311972,3390,343275,0.12
2025-09-14T14:13:45.304Z,Included,auto,No,40251,0,865149,5734,911134,0.28
2025-09-14T14:07:37.794Z,Included,auto,No,22860,0,201477,3692,228029,0.09
2025-09-14T14:06:53.651Z,Included,auto,No,35615,0,375497,4879,415991,0.15
2025-09-14T14:06:10.974Z,Included,auto,No,30254,0,271760,4334,306348,0.12
2025-09-14T14:05:23.611Z,Included,auto,No,8078,0,9193,274,17545,0.01
2025-09-14T14:02:30.958Z,Included,auto,No,5045,0,50116,450,55611,0.02
2025-09-14T13:59:05.556Z,Included,auto,No,27201,0,110278,3169,140648,0.07
2025-09-14T13:55:52.714Z,Included,auto,No,33829,0,487949,6361,528139,0.18
2025-09-14T13:54:59.923Z,Included,auto,No,50696,0,897580,5457,953733,0.30
2025-09-14T13:53:51.178Z,Included,auto,No,39565,0,507985,5171,552721,0.19
2025-09-14T13:17:53.895Z,Included,auto,No,79579,0,2171518,8393,2259490,0.66
2025-09-14T12:58:23.260Z,Included,auto,No,75088,0,1663056,8424,1746568,0.52
2025-09-14T11:00:45.469Z,Included,auto,No,22725,0,214776,4034,241535,0.09
2025-09-14T10:55:16.165Z,Included,auto,No,7037,0,143474,386,150897,0.04
2025-09-14T10:53:23.090Z,Included,auto,No,37244,0,94765,404,132413,0.06
2025-09-14T10:48:16.476Z,Included,auto,No,0,7058,0,14,7072,0.01
2025-09-14T10:27:38.290Z,Included,auto,No,12091,0,19385,4458,35934,0.03
2025-09-14T10:00:18.287Z,Included,auto,No,3080,0,73848,672,77600,0.02
2025-09-14T09:57:10.380Z,Included,auto,No,27933,0,746901,5034,779868,0.23
2025-09-14T09:53:30.612Z,Included,auto,No,1614,0,170146,725,172485,0.05
2025-09-14T09:50:14.932Z,Included,auto,No,5285,0,47505,360,53150,0.02
2025-09-14T09:49:31.884Z,Included,auto,No,2523,0,143977,2035,148535,0.05
2025-09-14T09:46:57.627Z,Included,auto,No,12731,0,101028,1020,114779,0.04
2025-09-14T09:14:34.953Z,Included,auto,No,3515,0,533014,1312,537841,0.14
2025-09-14T09:11:53.216Z,Included,auto,No,10975,0,506655,4314,521944,0.15
2025-09-14T09:07:58.356Z,Included,auto,No,14609,0,92289,385,107283,0.04
2025-09-14T09:05:04.707Z,Included,auto,No,23419,0,925100,5066,953585,0.27
2025-09-14T09:01:14.834Z,Included,auto,No,21818,0,516647,4648,543113,0.17
2025-09-13T15:31:22.188Z,Included,auto,No,40861,0,624770,9717,675348,0.24
2025-09-13T15:24:51.073Z,Included,auto,No,25460,0,2357190,4944,2387594,0.63
2025-09-13T15:17:03.920Z,Included,auto,No,58930,0,1754634,15506,1829070,0.56
2025-09-13T15:02:17.798Z,Included,auto,No,39221,0,819110,4378,862709,0.26
2025-09-13T14:35:10.825Z,Included,auto,No,3370,0,27239,674,31283,0.01
2025-09-13T13:57:41.184Z,Included,auto,No,0,1574,0,139,1713,0.004
2025-09-13T12:48:23.232Z,Included,auto,No,63911,0,1190906,21857,1276674,0.45
2025-09-13T12:43:42.412Z,Included,auto,No,26563,0,209906,4374,240843,0.10
2025-09-13T12:41:45.532Z,Included,auto,No,18557,0,272436,4157,295150,0.10
2025-09-13T12:39:14.812Z,Included,auto,No,3069,0,291433,1193,295695,0.08
2025-09-13T12:33:06.427Z,Included,auto,No,63894,0,1376643,21795,1462332,0.50
2025-09-13T12:25:58.002Z,Included,auto,No,71117,0,2174093,19963,2265173,0.69
2025-09-13T12:15:24.378Z,Included,auto,No,4069,0,368751,1115,373935,0.10
2025-09-13T12:13:22.609Z,Included,auto,No,5411,0,233683,4173,243267,0.08
2025-09-13T11:59:58.445Z,Included,auto,No,109184,0,2832123,45084,2986391,1.00
2025-09-11T16:21:27.464Z,Included,auto,No,20581,0,365614,3590,389785,0.13
2025-09-11T16:17:48.211Z,Included,auto,No,22651,0,634286,4700,661637,0.20
2025-09-11T16:09:42.859Z,Included,auto,No,22100,0,412040,4461,438601,0.14
2025-09-11T15:59:14.384Z,Included,auto,No,4833,0,368718,2193,375744,0.11
2025-09-11T15:54:40.684Z,Included,auto,No,14764,0,726266,7130,748160,0.22
2025-09-11T15:50:33.422Z,Included,auto,No,22085,0,499881,6941,528907,0.17
2025-09-11T15:29:28.831Z,Included,auto,No,4999,0,100148,1637,106784,0.04
2025-09-11T15:12:55.893Z,Included,auto,No,8414,0,48152,900,57466,0.02
2025-09-11T14:53:47.740Z,Included,auto,No,13547,0,151913,2267,167727,0.06
2025-09-11T14:44:57.859Z,Included,auto,No,4748,0,292844,2466,300058,0.09
2025-09-11T14:41:41.689Z,Included,auto,No,16238,0,253692,8974,278904,0.12
2025-09-11T14:38:51.936Z,Included,auto,No,4937,0,28758,1790,35485,0.02
2025-09-11T14:36:48.182Z,Included,auto,No,0,1525,0,7,1532,0.00
2025-09-11T14:35:24.433Z,Included,auto,No,1848,0,60036,475,62359,0.02
2025-09-11T14:34:26.817Z,Included,auto,No,1916,0,24993,999,27908,0.01
2025-09-11T14:33:33.656Z,Included,auto,No,1439,0,22141,676,24256,0.01
2025-09-11T14:31:51.828Z,Included,auto,No,1605,0,28082,933,30620,0.01
2025-09-11T14:30:28.986Z,Included,auto,No,3883,0,26125,1077,31085,0.01
2025-09-11T14:27:35.095Z,Included,auto,No,0,1544,0,37,1581,0.00
2025-09-11T14:27:14.375Z,Included,auto,No,0,1895,0,245,2140,0.01
2025-09-11T14:23:18.377Z,Included,auto,No,2370,0,55611,1089,59070,0.02
2025-09-11T14:22:11.268Z,Included,auto,No,5797,0,53373,1430,60600,0.02
2025-09-11T14:21:50.628Z,"Errored, Not Charged",auto,No,0,0,0,0,0,0.00
2025-09-10T14:10:54.253Z,Included,auto,No,42921,0,887754,3439,934114,0.28
2025-09-10T14:04:50.095Z,Included,auto,No,29680,0,1528010,7160,1564850,0.44
2025-09-10T14:00:15.952Z,Included,auto,No,19404,5184,821197,3247,849032,0.24
2025-09-10T13:53:34.296Z,Included,auto,No,27625,0,532562,6066,566253,0.19
2025-09-10T13:44:33.751Z,Included,auto,No,17757,0,420086,3695,441538,0.14
2025-09-10T13:40:58.177Z,Included,auto,No,13214,0,151066,2090,166370,0.06
2025-09-10T13:29:32.579Z,Included,auto,No,26437,0,485578,5798,517813,0.17
2025-09-10T12:38:30.014Z,Included,auto,No,27462,1301,703768,2422,734953,0.22
2025-09-10T12:34:29.867Z,Included,auto,No,12981,524,252402,3121,269028,0.09
2025-09-10T12:34:25.238Z,Included,auto,No,0,0,0,0,0,0.00
2025-09-10T12:26:46.283Z,Included,auto,No,6625,0,20878,453,27956,0.01
2025-09-09T16:34:33.693Z,Included,auto,No,11724,1106,228928,3363,245121,Included
2025-09-09T15:44:19.745Z,Included,auto,No,0,5880,0,258,6138,Included
2025-09-09T15:43:15.542Z,Included,auto,No,0,1768,0,260,2028,Included
2025-09-09T15:42:56.122Z,Included,auto,No,0,4930,0,252,5182,Included
2025-09-09T15:42:24.451Z,Included,auto,No,0,4879,0,106,4985,Included
2025-09-09T15:41:52.501Z,Included,auto,No,0,353,4864,276,5493,Included
2025-09-09T15:41:29.792Z,Included,auto,No,0,4904,0,231,5135,Included
2025-09-09T15:26:08.371Z,Included,auto,No,32169,0,429186,4449,465804,Included
2025-09-09T15:20:23.883Z,Included,auto,No,38178,0,515604,6307,560089,Included
2025-09-09T15:12:21.012Z,Included,auto,No,28108,0,1677272,16116,1721496,Included
2025-09-09T15:07:32.656Z,Included,auto,No,45733,0,611200,6525,663458,Included
2025-09-09T11:33:56.466Z,"Errored, Not Charged",auto,No,1249,0,8168,51,9468,Included
2025-09-09T11:32:14.349Z,Included,auto,No,1046,0,15115,225,16386,Included
2025-09-09T11:28:19.117Z,Included,auto,No,0,2189,0,18,2207,Included
2025-09-08T16:48:39.915Z,Included,auto,No,12167,0,858543,2315,873025,Included
2025-09-08T16:44:26.071Z,Included,auto,No,42291,0,1069643,6074,1118008,Included
2025-09-08T16:37:39.413Z,"Errored, Not Charged",auto,No,17949,0,919334,6860,944143,Included
2025-09-08T16:33:27.865Z,Included,auto,No,31096,0,425771,3623,460490,Included
2025-09-08T16:25:21.392Z,Included,auto,No,31864,0,1766681,14148,1812693,Included
2025-09-08T16:20:33.830Z,Included,auto,No,42232,0,651296,4931,698459,Included
2025-09-08T15:52:44.909Z,"Errored, Not Charged",auto,No,33164,0,409133,3052,445349,Included
2025-09-08T15:49:50.935Z,Included,auto,No,16481,0,874405,5248,896134,Included
2025-09-08T15:42:01.249Z,Included,auto,No,55998,0,1471808,7921,1535727,Included
2025-09-07T16:11:22.112Z,Included,auto,No,31148,0,104099,3221,138468,Included
2025-09-07T15:55:27.977Z,Included,auto,No,14837,0,278906,2269,296012,Included
2025-09-07T15:48:55.390Z,"Errored, Not Charged",auto,No,21155,0,108864,1968,131987,Included
2025-09-07T15:28:20.933Z,Included,auto,No,0,6373,0,42,6415,Included
2025-09-07T15:28:06.566Z,Included,auto,No,0,6027,0,42,6069,Included
2025-09-07T15:25:05.768Z,Included,auto,No,12077,0,76704,1503,90284,Included
2025-09-07T15:24:22.936Z,Included,auto,No,6140,0,118414,1532,126086,Included
2025-09-07T15:23:10.790Z,Included,auto,No,19710,0,179988,957,200655,Included
2025-09-07T15:22:13.117Z,Included,auto,No,8577,0,36081,1486,46144,Included
2025-09-07T15:18:46.261Z,Included,auto,No,4955,0,53445,725,59125,Included
2025-09-07T15:18:08.140Z,Included,auto,No,2325,0,28648,928,31901,Included
2025-09-07T15:17:08.028Z,Included,auto,No,4069,0,54584,1719,60372,Included
2025-09-07T15:15:29.689Z,"Errored, Not Charged",auto,No,12105,0,55317,1605,69027,Included
2025-09-07T15:13:59.885Z,Included,auto,No,2490,0,214482,1360,218332,Included
2025-09-07T15:12:40.666Z,Included,auto,No,9188,0,269716,1659,280563,Included
2025-09-07T15:03:23.223Z,Included,auto,No,27939,0,893382,3332,924653,Included
2025-09-07T15:01:10.723Z,"Errored, Not Charged",auto,No,29120,0,448698,3216,481034,Included
2025-09-07T13:20:34.993Z,Included,auto,No,22147,869,132797,2947,158760,Included
2025-09-07T13:18:37.546Z,Included,auto,No,19666,0,195763,2391,217820,Included
2025-09-07T13:11:15.490Z,Included,auto,No,16372,0,21391,6529,44292,Included
2025-09-07T13:03:38.270Z,Included,auto,No,1684,0,69315,470,71469,Included
2025-09-07T12:55:37.488Z,Included,auto,No,26177,0,902130,5004,933311,Included
2025-09-07T12:51:41.329Z,Included,auto,No,25525,0,365832,5556,396913,Included
2025-09-07T12:49:03.765Z,Included,auto,No,2957,0,161288,628,164873,Included
2025-09-07T12:47:29.613Z,Included,auto,No,4152,0,249952,999,255103,Included
2025-09-07T12:46:10.628Z,Included,auto,No,2992,0,138433,1351,142776,Included
2025-09-07T12:44:03.726Z,Included,auto,No,2197,0,86295,1077,89569,Included
2025-09-07T12:40:48.199Z,Included,auto,No,35028,0,413030,8507,456565,Included
2025-09-07T12:21:30.733Z,Included,auto,No,46147,0,1327660,16862,1390669,Included
2025-09-07T12:15:18.528Z,Included,auto,No,9973,0,219230,847,230050,Included
2025-09-07T12:02:41.088Z,Included,auto,No,23146,0,377104,2746,402996,Included
2025-09-07T11:57:13.690Z,Included,auto,No,21355,0,408170,2833,432358,Included
2025-09-07T11:53:31.388Z,Included,auto,No,16966,0,714750,5448,737164,Included
2025-09-07T11:41:04.345Z,Included,auto,No,35761,0,680552,9858,726171,Included
2025-09-07T11:25:35.458Z,Included,auto,No,11299,0,614490,5939,631728,Included
2025-09-07T11:23:07.095Z,Included,auto,No,44157,0,458779,4049,506985,Included
2025-09-07T11:17:26.773Z,Included,auto,No,49654,0,1181211,8510,1239375,Included
2025-09-07T11:15:11.543Z,Included,auto,No,10599,638,648394,4453,664084,Included
2025-09-07T11:11:11.950Z,Included,auto,No,40853,0,682778,5438,729069,Included
2025-09-07T09:41:58.153Z,Included,auto,No,0,1215,0,41,1256,Included
2025-09-07T09:41:43.299Z,Included,auto,No,0,1068,0,16,1084,Included
2025-09-07T09:41:35.509Z,Included,auto,No,0,996,0,11,1007,Included
2025-09-07T09:41:28.285Z,Included,auto,No,0,951,0,11,962,Included
2025-09-07T09:41:01.898Z,Included,auto,No,0,975,0,15,990,Included
2025-09-07T09:40:20.580Z,Included,auto,No,0,873,0,8,881,Included
2025-09-07T09:40:09.712Z,Included,auto,No,0,847,0,10,857,Included
2025-09-07T09:40:09.476Z,Included,auto,No,0,847,0,10,857,Included
2025-09-06T15:20:20.481Z,Included,auto,No,15644,0,220936,6405,242985,Included
2025-09-06T15:15:56.080Z,Included,auto,No,7066,0,407765,1291,416122,Included
2025-09-06T15:13:58.440Z,Included,auto,No,56936,0,192995,3151,253082,Included
2025-09-05T16:12:39.158Z,Included,auto,No,36503,2796,468332,10680,518311,Included
2025-09-05T15:54:54.760Z,Included,auto,No,33326,0,1641642,31787,1706755,Included
2025-09-05T15:47:17.446Z,"Errored, Not Charged",auto,No,37282,0,408253,14683,460218,Included
2025-09-05T15:43:19.335Z,"Errored, Not Charged",auto,No,63578,0,765925,5949,835452,Included
2025-09-05T15:35:44.106Z,Included,auto,No,0,4151,0,15,4166,Included
2025-09-05T15:33:30.947Z,Included,auto,No,0,8398,0,11,8409,Included
2025-09-05T15:30:28.545Z,Included,auto,No,0,8699,0,11,8710,Included
2025-09-05T15:25:12.244Z,Included,auto,No,20091,0,272094,4922,297107,Included
2025-09-05T15:12:59.374Z,Included,auto,No,11016,0,176101,1779,188896,Included
2025-09-05T15:08:52.308Z,Included,auto,No,19010,0,1329581,4826,1353417,Included
2025-09-05T15:05:06.195Z,Included,auto,No,40295,0,1042835,6123,1089253,Included
2025-09-05T14:57:20.568Z,Included,auto,No,0,3092,0,17,3109,Included
2025-09-05T14:40:04.916Z,"Errored, Not Charged",auto,No,44608,0,199414,12074,256096,Included
2025-09-03T16:01:32.045Z,Included,auto,No,16483,0,245438,2622,264543,Included
2025-09-03T15:59:26.239Z,Included,auto,No,7477,0,32137,859,40473,Included
2025-09-01T14:56:45.050Z,Included,auto,No,0,371,2688,218,3277,Included
2025-09-01T14:56:30.117Z,Included,auto,No,0,883,2176,220,3279,Included
2025-09-01T14:55:46.918Z,Included,auto,No,0,241,2816,199,3256,Included
2025-09-01T14:55:13.055Z,Included,auto,No,0,2828,0,129,2957,Included
2025-09-01T14:53:24.498Z,Included,auto,No,3845,0,51827,1508,57180,Included
2025-09-01T14:52:22.466Z,Included,auto,No,8776,0,43403,1732,53911,Included
2025-09-01T14:38:52.124Z,Included,auto,No,5072,0,22582,1374,29028,Included
2025-09-01T14:37:38.298Z,Included,auto,No,4430,0,17576,1162,23168,Included
2025-08-31T15:23:58.353Z,Included,auto,No,0,1030,0,55,1085,Included
2025-08-31T14:57:42.304Z,Included,auto,No,0,951,1280,19,2250,Included
2025-08-31T14:57:25.803Z,Included,auto,No,0,362,1280,10,1652,Included
2025-08-31T14:57:17.532Z,Included,auto,No,0,1512,0,19,1531,Included
2025-08-31T14:56:51.506Z,Included,auto,No,0,1411,0,19,1430,Included
2025-08-31T08:59:53.102Z,Included,auto,No,26906,0,1336749,5375,1369030,Included
2025-08-31T08:56:40.725Z,Included,auto,No,38249,0,742171,7544,787964,Included
2025-08-31T08:52:29.259Z,Included,auto,No,9423,0,366712,3357,379492,Included
2025-08-31T08:50:19.571Z,Included,auto,No,2385,0,158626,881,161892,Included
2025-08-31T08:48:35.182Z,Included,auto,No,16731,0,161526,1814,180071,Included
2025-08-31T08:46:24.974Z,Included,auto,No,9535,0,50471,1869,61875,Included
2025-08-31T08:34:02.909Z,Included,auto,No,1343,0,109999,802,112144,Included
2025-08-31T08:28:03.800Z,Included,auto,No,50884,0,394560,5168,450612,Included
2025-08-31T07:23:45.519Z,Included,auto,No,9717,0,518067,3611,531395,Included
2025-08-31T07:21:59.454Z,Included,auto,No,0,1224,0,14,1238,Included
2025-08-31T07:12:27.965Z,Included,auto,No,58947,0,444557,4823,508327,Included
2025-08-30T14:42:15.130Z,Included,auto,No,18626,0,629227,3568,651421,Included
2025-08-30T14:32:32.480Z,Included,auto,No,10417,0,210123,2462,223002,Included
2025-08-30T14:26:55.857Z,Included,auto,No,28535,0,512217,2725,543477,Included
2025-08-30T14:24:54.844Z,Included,auto,No,11558,0,87545,916,100019,Included
2025-08-30T14:23:48.099Z,Included,auto,No,11880,0,91305,960,104145,Included
2025-08-30T14:22:18.324Z,Included,auto,No,11586,0,132507,1947,146040,Included
2025-08-30T14:18:22.803Z,Included,auto,No,19985,0,81344,917,102246,Included
2025-08-30T14:15:40.977Z,Included,auto,No,4542,0,227607,1972,234121,Included
2025-08-30T14:14:40.158Z,"Errored, Not Charged",auto,No,18341,0,143902,2524,164767,Included
2025-08-30T14:06:21.623Z,Included,auto,No,0,4996,0,122,5118,Included
2025-08-30T14:04:10.879Z,Included,auto,No,0,279,4864,202,5345,Included
2025-08-30T14:04:00.580Z,Included,auto,No,0,4913,0,152,5065,Included
2025-08-30T13:59:11.075Z,Included,auto,No,5433,0,25040,1537,32010,Included
2025-08-30T12:49:35.552Z,Included,auto,No,0,3170,0,319,3489,Included
2025-08-30T06:16:39.239Z,Included,auto,No,0,1270,0,26,1296,Included
2025-08-30T06:16:30.950Z,Included,auto,No,0,950,0,26,976,Included
2025-08-29T15:39:20.571Z,Included,auto,No,0,748,1920,79,2747,Included
2025-08-29T15:39:11.783Z,Included,auto,No,0,2658,0,62,2720,Included
2025-08-29T15:24:40.212Z,Included,auto,No,6706,0,62162,1390,70258,Included
2025-08-29T14:38:15.695Z,Included,auto,No,1316,0,28482,761,30559,0.01
2025-08-29T14:36:39.355Z,Included,auto,No,5018,0,34705,924,40647,0.02
2025-08-29T14:35:22.109Z,Included,auto,No,0,982,1920,76,2978,0.004
2025-08-29T14:32:48.367Z,Included,auto,No,0,2896,0,80,2976,0.01
2025-08-29T14:07:10.198Z,Included,auto,No,0,213,2816,116,3145,0.003
2025-08-29T14:06:40.319Z,Included,auto,No,0,2877,0,78,2955,0.01
2025-08-29T13:14:15.924Z,Included,auto,No,3337,0,16180,583,20100,0.01
2025-08-29T09:25:11.199Z,Included,auto,No,15255,0,95659,857,111771,0.04
2025-08-29T09:23:50.776Z,Included,auto,No,6455,0,34167,2085,42707,0.02
2025-08-28T14:53:09.463Z,Included,auto,No,610,0,15401,391,16402,0.01
2025-08-28T14:52:25.008Z,Included,auto,No,3555,0,17850,507,21912,0.01
2025-08-28T14:40:36.896Z,Included,auto,No,0,4885,0,43,4928,0.01
2025-08-28T12:50:23.733Z,Included,auto,No,19867,0,26841,964,47672,0.03
2025-08-28T12:37:18.609Z,Included,auto,No,1132,0,43094,672,44898,0.01
2025-08-28T12:35:23.764Z,Included,auto,No,10710,0,98428,3840,112978,0.05
2025-08-28T12:33:42.459Z,Included,auto,No,6822,0,20869,1206,28897,0.02
2025-08-28T11:47:55.428Z,Included,auto,No,0,1687,0,12,1699,0.003
2025-08-28T11:46:58.548Z,Included,auto,No,0,3677,0,13,3690,0.01
2025-08-28T11:40:28.477Z,Included,auto,No,8021,0,499122,2513,509656,0.14
2025-08-28T11:40:17.809Z,Included,auto,No,0,3971,0,20,3991,0.01
2025-08-28T11:37:56.925Z,Included,auto,No,2403,0,86864,1298,90565,0.03
2025-08-28T11:31:09.360Z,Included,auto,No,7727,0,96368,2143,106238,0.04
2025-08-28T11:29:41.135Z,Included,auto,No,1018,0,4249,503,5770,0.004
2025-08-28T11:29:00.928Z,Included,auto,No,2594,0,8204,774,11572,0.01
2025-08-28T11:28:14.724Z,Included,auto,No,0,4426,1536,11,5973,0.01
2025-08-28T11:28:07.848Z,Included,auto,No,0,4315,1536,12,5863,0.01
2025-08-28T11:26:33.988Z,Included,auto,No,0,5556,0,21,5577,0.01
2025-08-28T11:25:26.856Z,Included,auto,No,0,678,0,12,690,0.001
2025-08-28T11:17:57.379Z,Included,auto,No,0,3859,1024,13,4896,0.01
2025-08-28T11:17:32.385Z,Included,auto,No,688,0,16879,447,18014,0.01
2025-08-28T11:16:33.942Z,Included,auto,No,0,4982,0,13,4995,0.01
2025-08-28T11:14:20.449Z,Included,auto,No,0,4451,0,7,4458,0.01
2025-08-28T11:13:57.605Z,Included,auto,No,0,4303,0,9,4312,0.01
2025-08-28T11:09:38.829Z,Included,auto,No,12494,0,230750,3386,246630,0.08
2025-08-28T11:07:54.798Z,Included,auto,No,1349,0,8098,418,9865,0.01
2025-08-28T08:49:01.608Z,Included,auto,No,0,3336,0,193,3529,0.01
2025-08-28T08:48:52.473Z,Included,auto,No,0,3174,0,61,3235,0.01
2025-08-27T15:32:23.210Z,Included,auto,No,6032,0,64034,3050,73116,0.03
2025-08-27T15:28:49.075Z,Included,auto,No,6441,0,72028,3228,81697,0.04
2025-08-27T15:18:31.652Z,Included,auto,No,6624,0,79472,2976,89072,0.04
2025-08-27T15:17:13.563Z,Included,auto,No,0,2743,2048,113,4904,0.01
2025-08-27T15:17:03.574Z,Included,auto,No,0,4596,0,14,4610,0.01
2025-08-27T15:16:25.899Z,Included,auto,No,0,2038,2048,14,4100,0.01
2025-08-27T15:16:15.233Z,Included,auto,No,0,2366,0,13,2379,0.005
2025-08-27T15:15:34.416Z,Included,auto,No,0,2643,0,14,2657,0.01
2025-08-27T15:14:23.768Z,Included,auto,No,0,3328,0,24,3352,0.01
2025-08-27T15:14:06.956Z,Included,auto,No,0,3212,0,24,3236,0.01
2025-08-27T15:11:54.292Z,Included,auto,No,0,2586,0,12,2598,0.01
2025-08-27T15:11:24.318Z,Included,auto,No,0,3732,0,13,3745,0.01
2025-08-27T15:03:18.525Z,Included,auto,No,70349,0,1411334,2751,1484434,0.43
2025-08-27T14:59:00.418Z,Included,auto,No,5331,0,68444,2684,76459,0.03
2025-08-27T14:53:26.643Z,Included,auto,No,0,862,0,16,878,0.002
2025-08-26T15:38:14.293Z,Included,auto,No,714,0,18172,253,19139,0.01
2025-08-26T15:36:21.662Z,Included,auto,No,4872,0,27790,476,33138,0.01
2025-08-26T15:16:02.595Z,Included,auto,No,41295,0,390640,1148,433083,0.14
2025-08-26T13:59:01.920Z,Included,auto,No,0,4635,0,18,4653,0.01
2025-08-26T13:57:33.457Z,Included,auto,No,4564,0,74859,863,80286,0.03
2025-08-26T13:20:50.885Z,"Errored, Not Charged",auto,No,12021,0,631344,2344,645709,0.18
2025-08-26T13:18:31.911Z,Included,auto,No,2591,0,43016,922,46529,0.02
2025-08-26T13:17:47.907Z,Included,auto,No,3600,0,34270,892,38762,0.02
2025-08-26T13:16:54.236Z,Included,auto,No,2738,0,33916,791,37445,0.01
2025-08-26T13:16:04.218Z,Included,auto,No,2230,0,15859,828,18917,0.01
2025-08-26T13:14:43.670Z,Included,auto,No,2703,0,26040,1670,30413,0.02
2025-08-26T13:13:57.981Z,Included,auto,No,855,0,9207,459,10521,0.005
2025-08-26T13:13:03.599Z,Included,auto,No,0,2348,2176,9,4533,0.01
2025-08-26T13:12:38.293Z,Included,auto,No,844,0,9108,344,10296,0.004
2025-08-26T13:11:31.168Z,Included,auto,No,0,2638,0,8,2646,0.01
2025-08-26T13:09:18.990Z,Included,auto,No,2721,0,35381,793,38895,0.01
2025-08-26T13:05:46.595Z,Included,auto,No,0,1533,0,9,1542,0.003
2025-08-25T15:23:01.382Z,Included,auto,No,10182,0,154507,2586,167275,0.06
2025-08-25T15:22:24.606Z,"Errored, Not Charged",auto,No,0,0,0,0,0,0.00
2025-08-25T12:07:29.301Z,Included,auto,No,0,2468,0,27,2495,0.01
2025-08-25T12:02:29.929Z,Included,auto,No,7699,0,113035,1716,122450,0.04
2025-08-25T11:52:44.283Z,Included,auto,No,2458,0,13578,1211,17247,0.01
2025-08-25T11:40:08.829Z,Included,auto,No,1840,0,88859,486,91185,0.03
2025-08-25T11:38:27.400Z,Included,auto,No,4911,0,46168,2482,53561,0.03
2025-08-24T15:42:48.910Z,Included,auto,No,18798,0,161687,1340,181825,0.06
2025-08-24T14:07:48.900Z,Included,auto,No,27873,0,248072,1609,277554,0.10
2025-08-24T13:47:38.660Z,"Errored, Not Charged",auto,No,5739,0,52091,663,58493,0.02
2025-08-24T13:01:28.534Z,Included,auto,No,11877,0,239022,2841,253740,0.08
2025-08-24T12:50:07.411Z,Included,auto,No,19443,0,163689,1681,184813,0.07
2025-08-24T12:41:00.982Z,"Errored, Not Charged",auto,No,22901,0,417205,4358,444464,0.14
2025-08-24T12:22:00.714Z,Included,auto,No,2905,0,123422,961,127288,0.04
2025-08-24T12:17:15.030Z,"Errored, Not Charged",auto,No,15188,0,1073241,5435,1093864,0.31
2025-08-24T10:33:09.723Z,"Errored, Not Charged",auto,No,6486,0,56685,524,63695,0.02
2025-08-24T09:13:34.915Z,Included,auto,No,88957,0,1733965,2666,1825588,0.53
2025-08-24T09:01:01.657Z,Included,auto,No,37966,0,289268,2363,329597,0.12
2025-08-23T15:36:39.361Z,Included,auto,No,4447,0,33081,734,38262,0.02
2025-08-23T15:16:45.517Z,Included,auto,No,0,2845,0,77,2922,0.01
2025-08-23T14:06:15.316Z,"Errored, Not Charged",auto,No,1759,0,106738,776,109273,0.03
2025-08-23T14:02:47.933Z,Included,auto,No,22020,0,184012,1331,207363,0.07
2025-08-23T12:35:28.461Z,Included,auto,No,10694,0,95065,993,106752,0.04
2025-08-23T12:30:09.130Z,Included,auto,No,7084,0,84742,1696,93522,0.04
2025-08-22T13:18:01.153Z,Included,auto,No,0,1531,2432,65,4028,0.005
2025-08-22T13:17:48.776Z,Included,auto,No,0,1717,2432,267,4416,0.01
2025-08-22T13:17:38.707Z,Included,auto,No,0,3919,0,65,3984,0.01
2025-08-22T13:17:24.089Z,Included,auto,No,0,750,2560,50,3360,0.003
2025-08-22T13:16:59.388Z,Included,auto,No,0,3342,0,110,3452,0.01
2025-08-22T07:59:47.904Z,Included,auto,No,4734,0,28747,861,34342,0.02
2025-08-22T07:53:36.399Z,Included,auto,No,4666,6064,118570,2865,132165,0.05
2025-08-22T07:49:57.091Z,Included,auto,No,7281,0,102445,2726,112452,0.04
2025-08-21T15:33:46.948Z,Included,auto,No,1514,0,23246,1142,25902,0.01
2025-08-21T15:31:21.623Z,Included,auto,No,7450,0,20665,936,29051,0.02
2025-08-21T15:03:50.095Z,Included,auto,No,0,2139,2048,18,4205,0.01
2025-08-21T15:03:34.954Z,Included,auto,No,0,3817,0,18,3835,0.01
2025-08-21T15:03:22.390Z,Included,auto,No,0,3349,0,18,3367,0.01
2025-08-21T15:02:58.490Z,Included,auto,No,0,2437,0,18,2455,0.01
2025-08-21T14:53:32.151Z,Included,auto,No,4658,0,26002,1136,31796,0.02
2025-08-21T14:43:55.358Z,Included,auto,No,5259,0,18148,1017,24424,0.01
2025-08-21T14:36:23.451Z,Included,auto,No,26381,0,104743,851,131975,0.06
2025-08-21T07:09:11.447Z,Included,auto,No,2502,0,20578,605,23685,0.01
2025-08-21T07:00:39.135Z,Included,auto,No,4548,0,57600,1836,63984,0.03
2025-08-21T06:59:03.777Z,Included,auto,No,4234,0,26094,693,31021,0.01
2025-08-20T16:15:01.009Z,Included,auto,No,6054,0,17420,1335,24809,0.02
2025-08-20T15:55:27.996Z,Included,auto,No,35632,0,812916,4286,852834,0.26
2025-08-20T15:21:09.202Z,Included,auto,No,3781,0,36695,359,40835,0.01
2025-08-20T15:18:00.676Z,Included,auto,No,10380,0,91753,2050,104183,0.04
2025-08-20T15:12:12.049Z,"Errored, Not Charged",auto,No,37362,0,601940,4397,643699,0.21
2025-08-20T15:10:00.566Z,Included,auto,No,10012,0,99812,1561,111385,0.04
2025-08-20T15:05:30.701Z,"Errored, Not Charged",auto,No,2537,0,118251,705,121493,0.03
2025-08-20T15:01:46.978Z,Included,auto,No,4417,0,180344,1870,186631,0.06
2025-08-20T14:58:33.273Z,Included,auto,No,19925,0,82794,1277,103996,0.05
2025-08-20T14:47:23.066Z,Included,auto,No,3810,0,27810,554,32174,0.01
2025-08-20T14:44:03.094Z,Included,auto,No,2714,0,318201,484,321399,0.08
2025-08-20T14:37:42.819Z,Included,auto,No,40318,0,278252,2878,321448,0.12
2025-08-20T12:38:30.159Z,Included,auto,No,27074,0,546609,2367,576050,0.17
2025-08-20T12:35:21.813Z,Included,auto,No,21047,0,199024,2385,222456,0.08
2025-08-20T12:33:10.272Z,Included,auto,No,0,3216,0,134,3350,0.01
2025-08-20T12:32:36.350Z,Included,auto,No,0,3121,0,168,3289,0.01
2025-08-20T12:25:13.047Z,Included,auto,No,9508,0,194734,1443,205685,0.06
2025-08-20T12:22:48.355Z,Included,auto,No,16362,0,185394,1634,203390,0.07
2025-08-20T12:18:25.638Z,Included,auto,No,4413,0,30538,1341,36292,0.02
2025-08-20T12:17:49.114Z,Included,auto,No,5357,0,3985,540,9882,0.01
2025-08-20T12:08:18.877Z,Included,auto,No,6582,0,150680,1805,159067,0.05
2025-08-20T12:07:08.309Z,Included,auto,No,2921,0,54691,956,58568,0.02
2025-08-20T12:06:37.488Z,Included,auto,No,278,0,9484,362,10124,0.004
2025-08-20T12:04:54.625Z,Included,auto,No,5483,0,29729,545,35757,0.02
2025-08-20T11:54:19.202Z,Included,auto,No,1342,0,77310,382,79034,0.02
2025-08-20T11:52:04.722Z,Included,auto,No,8822,0,227378,3996,240196,0.08
2025-08-20T11:46:20.603Z,Included,auto,No,25491,0,318716,7968,352175,0.14
2025-08-20T11:36:19.202Z,Included,auto,No,0,5134,0,28,5162,0.01
2025-08-20T11:20:26.551Z,Included,auto,No,611,0,18708,232,19551,0.01
2025-08-20T11:19:54.016Z,Included,auto,No,1753,0,32392,706,34851,0.01
2025-08-20T11:15:23.790Z,Included,auto,No,0,3855,1280,49,5184,0.01
2025-08-20T11:13:54.586Z,Included,auto,No,5339,0,28852,799,34990,0.02
2025-08-20T11:06:23.211Z,Included,auto,No,0,5254,0,329,5583,0.01
2025-08-20T11:04:53.441Z,Included,auto,No,0,4783,0,138,4921,0.01
2025-08-20T11:02:44.298Z,Included,auto,No,0,4958,0,73,5031,0.01
2025-08-20T11:02:26.325Z,Included,auto,No,0,5020,0,34,5054,0.01
2025-08-19T15:33:48.857Z,Included,auto,No,50704,0,156907,4610,212221,0.11
2025-08-19T15:09:56.334Z,Included,auto,No,50994,0,620061,8800,679855,0.24