Date,User,Kind,Model,Input (w/ Cache Write),Input (w/o Cache Write),Cache Read,Output,Total Tokens,Cost ($)
2025-08-22T13:18:01.153Z,You,Included in Pro,auto,0,1531,2432,65,4028,Included
2025-08-22T13:17:48.776Z,You,Included in Pro,auto,0,1717,2432,267,4416,Included
2025-08-22T13:17:38.707Z,You,Included in Pro,auto,0,3919,0,65,3984,Included
2025-08-22T13:17:24.089Z,You,Included in Pro,auto,0,750,2560,50,3360,Included
2025-08-22T13:16:59.388Z,You,Included in Pro,auto,0,3342,0,110,3452,Included
2025-08-22T07:59:47.904Z,You,Included in Pro,auto,4734,0,28747,861,34342,Included
2025-08-22T07:53:36.399Z,You,Included in Pro,auto,4666,6064,118570,2865,132165,Included
2025-08-22T07:49:57.091Z,You,Included in Pro,auto,7281,0,102445,2726,112452,Included
2025-08-21T15:33:46.948Z,You,Included in Pro,auto,1514,0,23246,1142,25902,Included
2025-08-21T15:31:21.623Z,You,Included in Pro,auto,7450,0,20665,936,29051,Included
2025-08-21T15:03:50.095Z,You,Included in Pro,auto,0,2139,2048,18,4205,Included
2025-08-21T15:03:34.954Z,You,Included in Pro,auto,0,3817,0,18,3835,Included
2025-08-21T15:03:22.390Z,You,Included in Pro,auto,0,3349,0,18,3367,Included
2025-08-21T15:02:58.490Z,You,Included in Pro,auto,0,2437,0,18,2455,Included
2025-08-21T14:53:32.151Z,You,Included in Pro,auto,4658,0,26002,1136,31796,Included
2025-08-21T14:43:55.358Z,You,Included in Pro,auto,5259,0,18148,1017,24424,Included
2025-08-21T14:36:23.451Z,You,Included in Pro,auto,26381,0,104743,851,131975,Included
2025-08-21T07:09:11.447Z,You,Included in Pro,auto,2502,0,20578,605,23685,Included
2025-08-21T07:00:39.135Z,You,Included in Pro,auto,4548,0,57600,1836,63984,Included
2025-08-21T06:59:03.777Z,You,Included in Pro,auto,4234,0,26094,693,31021,Included
2025-08-20T16:15:01.009Z,You,Included in Pro,auto,6054,0,17420,1335,24809,Included
2025-08-20T15:55:27.996Z,You,Included in Pro,auto,35632,0,812916,4286,852834,Included
2025-08-20T15:21:09.202Z,You,Included in Pro,auto,3781,0,36695,359,40835,Included
2025-08-20T15:18:00.676Z,You,Included in Pro,auto,10380,0,91753,2050,104183,Included
2025-08-20T15:12:12.049Z,You,"Errored, Not Charged",auto,37362,0,601940,4397,643699,Included
2025-08-20T15:10:00.566Z,You,Included in Pro,auto,10012,0,99812,1561,111385,Included
2025-08-20T15:05:30.701Z,You,"Errored, Not Charged",auto,2537,0,118251,705,121493,Included
2025-08-20T15:01:46.978Z,You,Included in Pro,auto,4417,0,180344,1870,186631,Included
2025-08-20T14:58:33.273Z,You,Included in Pro,auto,19925,0,82794,1277,103996,Included
2025-08-20T14:47:23.066Z,You,Included in Pro,auto,3810,0,27810,554,32174,Included
2025-08-20T14:44:03.094Z,You,Included in Pro,auto,2714,0,318201,484,321399,Included
2025-08-20T14:37:42.819Z,You,Included in Pro,auto,40318,0,278252,2878,321448,Included
2025-08-20T12:38:30.159Z,You,Included in Pro,auto,27074,0,546609,2367,576050,Included
2025-08-20T12:35:21.813Z,You,Included in Pro,auto,21047,0,199024,2385,222456,Included
2025-08-20T12:33:10.272Z,You,Included in Pro,auto,0,3216,0,134,3350,Included
2025-08-20T12:32:36.350Z,You,Included in Pro,auto,0,3121,0,168,3289,Included
2025-08-20T12:25:13.047Z,You,Included in Pro,auto,9508,0,194734,1443,205685,Included
2025-08-20T12:22:48.355Z,You,Included in Pro,auto,16362,0,185394,1634,203390,Included
2025-08-20T12:18:25.638Z,You,Included in Pro,auto,4413,0,30538,1341,36292,Included
2025-08-20T12:17:49.114Z,You,Included in Pro,auto,5357,0,3985,540,9882,Included
2025-08-20T12:08:18.877Z,You,Included in Pro,auto,6582,0,150680,1805,159067,Included
2025-08-20T12:07:08.309Z,You,Included in Pro,auto,2921,0,54691,956,58568,Included
2025-08-20T12:06:37.488Z,You,Included in Pro,auto,278,0,9484,362,10124,Included
2025-08-20T12:04:54.625Z,You,Included in Pro,auto,5483,0,29729,545,35757,Included
2025-08-20T11:54:19.202Z,You,Included in Pro,auto,1342,0,77310,382,79034,Included
2025-08-20T11:52:04.722Z,You,Included in Pro,auto,8822,0,227378,3996,240196,Included
2025-08-20T11:46:20.603Z,You,Included in Pro,auto,25491,0,318716,7968,352175,Included
2025-08-20T11:36:19.202Z,You,Included in Pro,auto,0,5134,0,28,5162,Included
2025-08-20T11:20:26.551Z,You,Included in Pro,auto,611,0,18708,232,19551,Included
2025-08-20T11:19:54.016Z,You,Included in Pro,auto,1753,0,32392,706,34851,Included
2025-08-20T11:15:23.790Z,You,Included in Pro,auto,0,3855,1280,49,5184,Included
2025-08-20T11:13:54.586Z,You,Included in Pro,auto,5339,0,28852,799,34990,Included
2025-08-20T11:06:23.211Z,You,Included in Pro,auto,0,5254,0,329,5583,Included
2025-08-20T11:04:53.441Z,You,Included in Pro,auto,0,4783,0,138,4921,Included
2025-08-20T11:02:44.298Z,You,Included in Pro,auto,0,4958,0,73,5031,Included
2025-08-20T11:02:26.325Z,You,Included in Pro,auto,0,5020,0,34,5054,Included
2025-08-19T15:33:48.857Z,You,Included in Pro,auto,50704,0,156907,4610,212221,Included
2025-08-19T15:09:56.334Z,You,Included in Pro,auto,50994,0,620061,8800,679855,Included
2025-08-19T12:10:38.142Z,You,Included in Pro,auto,3078,0,14693,1713,19484,Included
2025-08-19T12:09:54.635Z,You,Included in Pro,auto,1423,0,22307,911,24641,Included
2025-08-19T12:09:00.174Z,You,Included in Pro,auto,2674,0,34484,1564,38722,Included
2025-08-19T12:06:43.169Z,You,Included in Pro,auto,4399,0,16867,1072,22338,Included
2025-08-19T11:16:46.176Z,You,Included in Pro,auto,2369,0,14401,1211,17981,Included
2025-08-19T11:14:50.824Z,You,Included in Pro,auto,954,0,18355,370,19679,Included
2025-08-19T11:13:17.922Z,You,Included in Pro,auto,1894,0,13425,697,16016,Included
2025-08-19T11:12:29.129Z,You,Included in Pro,auto,0,2237,0,10,2247,Included
2025-08-18T12:06:52.427Z,You,Included in Pro,auto,0,5409,0,105,5514,Included
2025-08-18T12:06:43.614Z,You,Included in Pro,auto,0,5377,0,104,5481,Included
2025-08-18T08:58:18.476Z,You,Included in Pro,auto,0,5360,0,15,5375,Included
2025-08-18T07:05:03.393Z,You,Included in Pro,auto,42554,0,611822,11535,665911,Included
2025-08-18T05:14:08.530Z,You,Included in Pro,auto,2865,0,26125,1035,30025,Included
2025-08-17T14:55:43.838Z,You,Included in Pro,auto,0,2629,0,132,2761,Included
2025-08-17T14:53:13.726Z,You,Included in Pro,auto,0,3741,0,134,3875,Included
2025-08-17T14:53:06.995Z,You,Included in Pro,auto,0,408,3584,93,4085,Included
2025-08-17T14:52:59.358Z,You,Included in Pro,auto,0,613,3072,68,3753,Included
2025-08-17T14:45:07.762Z,You,Included in Pro,auto,0,3542,0,41,3583,Included
2025-08-17T14:41:55.806Z,You,Included in Pro,auto,0,3470,0,65,3535,Included
2025-08-17T12:50:04.924Z,You,Included in Pro,auto,1898,0,13309,736,15943,Included
2025-08-17T12:31:14.966Z,You,Included in Pro,auto,2056,2899,13531,1241,19727,Included
2025-08-17T12:28:41.004Z,You,Included in Pro,auto,2230,0,19359,718,22307,Included
2025-08-17T09:12:56.512Z,You,Included in Pro,auto,0,1012,1024,97,2133,Included
2025-08-17T09:12:47.343Z,You,Included in Pro,auto,0,2096,0,182,2278,Included
2025-08-17T09:12:40.388Z,You,Included in Pro,auto,0,1867,0,76,1943,Included
2025-08-17T09:12:33.331Z,You,Included in Pro,auto,0,2000,0,82,2082,Included
2025-08-17T09:12:23.564Z,You,Included in Pro,auto,0,1972,0,50,2022,Included
2025-08-17T08:37:34.736Z,You,Included in Pro,auto,0,1018,0,14,1032,Included
2025-08-16T14:02:33.327Z,You,Included in Pro,auto,14060,0,104074,1332,119466,Included
2025-08-16T13:14:05.773Z,You,Included in Pro,auto,8263,0,34747,755,43765,Included
2025-08-16T06:21:23.440Z,You,Included in Pro,auto,2807,0,25450,1131,29388,Included
2025-08-15T12:49:50.732Z,You,Included in Pro,auto,4475,0,22463,2351,29289,Included
2025-08-15T12:48:00.216Z,You,Included in Pro,auto,5991,0,13599,1214,20804,Included
2025-08-15T12:46:25.072Z,You,Included in Pro,auto,17572,0,4009,309,21890,Included
2025-08-15T12:44:44.535Z,You,Included in Pro,auto,0,3883,0,11,3894,Included
2025-08-15T12:34:27.491Z,You,Included in Pro,auto,12891,0,217485,5039,235415,Included
2025-08-15T12:33:11.822Z,You,Included in Pro,auto,7644,0,12751,1625,22020,Included
2025-08-15T11:42:43.561Z,You,Included in Pro,auto,15772,0,326136,2133,344041,Included
2025-08-15T10:09:29.830Z,You,Included in Pro,auto,0,1290,0,8,1298,Included
2025-08-14T15:57:08.477Z,You,Included in Pro,auto,0,565,2560,469,3594,Included
2025-08-14T15:56:52.027Z,You,Included in Pro,auto,0,2578,0,453,3031,Included
2025-08-14T15:55:17.760Z,You,Included in Pro,auto,0,2080,0,154,2234,Included
2025-08-14T15:55:05.493Z,You,Included in Pro,auto,0,2172,0,154,2326,Included
2025-08-14T15:54:45.130Z,You,Included in Pro,auto,0,2169,0,152,2321,Included
2025-08-14T15:54:25.255Z,You,Included in Pro,auto,0,3717,0,152,3869,Included
2025-08-14T15:54:02.062Z,You,Included in Pro,auto,0,3714,0,152,3866,Included
2025-08-14T15:53:47.887Z,You,Included in Pro,auto,0,5555,0,152,5707,Included
2025-08-14T15:53:19.020Z,You,Included in Pro,auto,0,2291,0,145,2436,Included
2025-08-14T15:53:01.451Z,You,Included in Pro,auto,0,2189,0,145,2334,Included
2025-08-14T15:52:44.278Z,You,Included in Pro,auto,0,5575,0,153,5728,Included
2025-08-14T15:46:09.525Z,You,Included in Pro,auto,49626,0,287808,3853,341287,Included
2025-08-14T15:24:25.588Z,You,Included in Pro,auto,30954,0,379244,9413,419611,Included
2025-08-14T15:16:34.807Z,You,Included in Pro,auto,0,7532,0,174,7706,Included
2025-08-14T15:15:04.759Z,You,Included in Pro,auto,0,306,7168,118,7592,Included
2025-08-14T15:14:35.771Z,You,Included in Pro,auto,0,7474,0,117,7591,Included
2025-08-14T15:13:09.919Z,You,Included in Pro,auto,0,7726,0,355,8081,Included
2025-08-14T15:12:11.910Z,You,Included in Pro,auto,0,7572,0,219,7791,Included
2025-08-14T15:11:04.272Z,You,Included in Pro,auto,0,7524,0,157,7681,Included
2025-08-14T15:09:31.039Z,You,Included in Pro,auto,0,5685,1792,157,7634,Included
2025-08-14T15:09:01.966Z,You,Included in Pro,auto,0,7473,0,157,7630,Included
2025-08-14T15:08:48.372Z,You,Included in Pro,auto,0,2169,0,157,2326,Included
2025-08-14T15:08:33.936Z,You,Included in Pro,auto,0,2173,0,157,2330,Included
2025-08-14T15:08:16.781Z,You,Included in Pro,auto,0,2175,0,157,2332,Included
2025-08-14T15:07:53.184Z,You,Included in Pro,auto,0,6143,0,213,6356,Included
2025-08-14T15:07:31.853Z,You,Included in Pro,auto,0,5721,0,213,5934,Included
2025-08-14T15:07:10.050Z,You,Included in Pro,auto,0,6593,0,213,6806,Included
2025-08-14T15:06:42.452Z,You,Included in Pro,auto,0,5040,1536,213,6789,Included
2025-08-14T15:06:12.205Z,You,Included in Pro,auto,0,6297,0,36,6333,Included
2025-08-14T15:03:57.291Z,You,"Errored, Not Charged",auto,48014,0,331458,5236,384708,Included
2025-08-14T14:50:07.969Z,You,Included in Pro,auto,8071,0,298922,5069,312062,Included
2025-08-14T14:48:23.576Z,You,Included in Pro,auto,26733,0,133544,705,160982,Included
2025-08-14T14:45:38.076Z,You,"Errored, Not Charged",auto,79470,0,2541200,5871,2626541,Included
2025-08-14T14:33:52.266Z,You,Included in Pro,auto,35261,0,384783,2228,422272,Included
2025-08-14T13:00:14.050Z,You,Included in Pro,auto,19427,0,415708,7200,442335,Included
2025-08-14T12:57:56.701Z,You,Included in Pro,auto,17828,0,71018,2859,91705,Included
2025-08-14T12:54:11.648Z,You,Included in Pro,auto,6458,0,21215,752,28425,Included
2025-08-14T10:59:37.971Z,You,Included in Pro,auto,7097,0,38868,1540,47505,Included
2025-08-14T10:14:12.180Z,You,Included in Pro,auto,0,4179,0,18,4197,Included
2025-08-14T10:14:00.897Z,You,Included in Pro,auto,0,4001,0,18,4019,Included
2025-08-14T09:57:08.241Z,You,Included in Pro,auto,72088,0,2151243,10326,2233657,Included
2025-08-14T09:36:15.810Z,You,Included in Pro,auto,12042,0,87059,2207,101308,Included
2025-08-14T07:18:35.693Z,You,Included in Pro,auto,0,1039,0,7,1046,Included
2025-08-14T07:18:18.041Z,You,Included in Pro,auto,0,1043,0,163,1206,Included
2025-08-14T05:19:46.793Z,You,Included in Pro,auto,0,324,1024,8,1356,Included
2025-08-14T05:19:15.811Z,You,Included in Pro,auto,0,1219,0,10,1229,Included
2025-08-13T15:25:23.593Z,You,Included in Pro,auto,7373,0,622338,4367,634078,Included
2025-08-13T15:22:42.044Z,You,Included in Pro,auto,49794,0,600119,2941,652854,Included
2025-08-13T15:12:08.122Z,You,Included in Pro,auto,0,8493,0,14,8507,Included
2025-08-13T15:07:48.336Z,You,Included in Pro,auto,14843,0,750927,6051,771821,Included
2025-08-13T15:07:04.713Z,You,"Errored, Not Charged",auto,0,0,0,0,0,Included
2025-08-13T12:06:20.213Z,You,Included in Pro,auto,0,9251,0,10,9261,Included
2025-08-13T12:05:53.916Z,You,Included in Pro,auto,0,9087,0,14,9101,Included
2025-08-13T12:05:34.744Z,You,Included in Pro,auto,0,8996,0,10,9006,Included
2025-08-12T15:31:21.161Z,You,Included in Pro,auto,152,0,10106,222,10480,Included
2025-08-12T15:30:47.496Z,You,Included in Pro,auto,721,0,28845,347,29913,Included
2025-08-12T15:30:03.627Z,You,Included in Pro,auto,5548,0,12614,299,18461,Included
2025-08-12T15:29:41.796Z,You,Included in Pro,auto,0,9306,0,20,9326,Included
2025-08-12T15:19:22.190Z,You,Included in Pro,auto,4652,0,12075,217,16944,Included
2025-08-12T15:19:00.674Z,You,Included in Pro,auto,0,4441,4736,22,9199,Included
2025-08-12T15:18:23.673Z,You,Included in Pro,auto,0,9128,0,18,9146,Included
2025-08-12T11:41:33.416Z,You,Included in Pro,auto,21440,0,28741,371,50552,Included
2025-08-12T11:39:57.750Z,You,Included in Pro,auto,1700,0,118113,842,120655,Included
2025-08-12T11:34:25.180Z,You,Included in Pro,auto,19073,0,39069,2340,60482,Included
2025-08-12T11:30:25.065Z,You,Included in Pro,auto,3686,0,146805,1285,151776,Included
2025-08-12T11:29:10.564Z,You,Included in Pro,auto,17213,0,23989,652,41854,Included
2025-08-12T11:26:50.851Z,You,Included in Pro,auto,15986,0,22942,580,39508,Included
2025-08-12T10:57:51.627Z,You,Included in Pro,auto,0,4206,0,113,4319,Included
2025-08-12T09:58:43.183Z,You,Included in Pro,auto,0,1819,0,52,1871,Included
2025-08-12T07:02:19.331Z,You,Included in Pro,auto,0,2086,2944,263,5293,Included
2025-08-12T07:02:06.654Z,You,Included in Pro,auto,0,3271,0,378,3649,Included
2025-08-12T06:58:55.193Z,You,Included in Pro,auto,0,2186,3456,381,6023,Included
2025-08-12T06:58:35.529Z,You,Included in Pro,auto,0,5698,0,473,6171,Included
2025-08-12T06:57:33.133Z,You,Included in Pro,auto,0,5149,0,182,5331,Included
2025-08-12T06:57:10.580Z,You,Included in Pro,auto,0,5232,0,408,5640,Included
2025-08-12T06:53:56.823Z,You,Included in Pro,auto,2845,0,44299,2346,49490,Included
2025-08-12T06:48:50.322Z,You,Included in Pro,auto,1134,0,42265,547,43946,Included
2025-08-12T06:44:15.058Z,You,Included in Pro,auto,3237,0,35632,2165,41034,Included
2025-08-12T06:43:20.542Z,You,Included in Pro,auto,13806,0,19589,409,33804,Included
2025-08-12T06:21:45.875Z,You,Included in Pro,auto,7276,0,26518,2262,36056,Included
2025-08-12T06:19:34.720Z,You,Included in Pro,auto,14355,0,22314,3424,40093,Included
2025-08-12T06:07:52.750Z,You,Included in Pro,auto,3297,0,21516,2100,26913,Included
2025-08-12T06:07:14.182Z,You,Included in Pro,auto,424,0,10196,242,10862,Included
2025-08-12T06:05:09.942Z,You,Included in Pro,auto,6357,0,14736,2177,23270,Included
2025-08-11T16:30:21.416Z,You,Included in Pro,auto,1496,0,22087,617,24200,Included
2025-08-11T16:28:49.895Z,You,Included in Pro,auto,3128,0,21790,603,25521,Included
2025-08-11T16:23:40.842Z,You,Included in Pro,auto,4976,0,63444,2156,70576,Included
2025-08-11T16:21:49.759Z,You,Included in Pro,auto,3258,0,46933,1272,51463,Included
2025-08-11T16:20:38.899Z,You,Included in Pro,auto,756,0,9226,403,10385,Included
2025-08-11T16:15:42.009Z,You,Included in Pro,auto,1598,0,12824,788,15210,Included
2025-08-11T16:14:54.477Z,You,Included in Pro,auto,1571,0,19382,698,21651,Included
2025-08-11T16:13:40.783Z,You,Included in Pro,auto,1476,0,14826,497,16799,Included
2025-08-11T16:12:06.501Z,You,Included in Pro,auto,2192,0,14731,312,17235,Included
2025-08-11T15:53:02.894Z,You,Included in Pro,auto,4192,0,104143,1790,110125,Included
2025-08-11T15:49:28.237Z,You,Included in Pro,auto,0,2261,0,9,2270,Included
2025-08-11T15:48:19.617Z,You,Included in Pro,auto,0,2073,0,9,2082,Included
2025-08-11T11:16:12.871Z,You,Included in Pro,auto,6740,0,12175,692,19607,Included
2025-08-11T11:15:01.236Z,You,Included in Pro,auto,0,3700,2432,251,6383,Included
2025-08-11T11:14:26.239Z,You,Included in Pro,auto,0,6006,0,89,6095,Included
2025-08-11T11:13:59.173Z,You,Included in Pro,auto,0,5004,1024,77,6105,Included
2025-08-11T11:13:34.112Z,You,Included in Pro,auto,0,6238,0,104,6342,Included
2025-08-11T11:12:31.064Z,You,Included in Pro,auto,0,6395,0,101,6496,Included
2025-08-11T11:12:02.759Z,You,Included in Pro,auto,0,6381,0,61,6442,Included
2025-08-11T11:11:42.673Z,You,Included in Pro,auto,0,5924,0,51,5975,Included
2025-08-11T11:11:24.351Z,You,Included in Pro,auto,0,5628,0,56,5684,Included
2025-08-11T11:10:51.577Z,You,Included in Pro,auto,0,228,5504,159,5891,Included
2025-08-11T11:10:38.739Z,You,Included in Pro,auto,0,5526,0,134,5660,Included
2025-08-11T07:11:00.704Z,You,Included in Pro,auto,0,3793,0,44,3837,Included
2025-08-11T06:47:30.684Z,You,Included in Pro,auto,0,3515,0,105,3620,Included
2025-08-11T06:41:32.243Z,You,Included in Pro,auto,0,3545,0,26,3571,Included
2025-08-11T05:27:29.087Z,You,Included in Pro,auto,14055,0,47705,2585,64345,Included
2025-08-11T05:22:14.509Z,You,Included in Pro,auto,27203,0,125097,9565,161865,Included
2025-08-11T05:11:52.952Z,You,Included in Pro,auto,9089,0,51008,4546,64643,Included
2025-08-11T05:09:21.139Z,You,Included in Pro,auto,7164,0,35884,4157,47205,Included
2025-08-11T05:06:36.387Z,You,Included in Pro,auto,13873,0,27609,3572,45054,Included
2025-08-11T04:59:11.250Z,You,Included in Pro,auto,15835,0,99036,1710,116581,Included
2025-08-11T04:55:31.295Z,You,Included in Pro,auto,15168,0,55624,596,71388,Included
2025-08-10T15:19:30.953Z,You,Included in Pro,auto,1620,0,13107,612,15339,Included
2025-08-10T15:10:53.174Z,You,Included in Pro,auto,1393,0,27909,404,29706,Included
2025-08-10T14:55:13.977Z,You,Included in Pro,auto,3035,0,55785,875,59695,Included
2025-08-10T12:49:39.293Z,You,Included in Pro,auto,5861,0,92276,757,98894,Included
2025-08-10T12:47:16.412Z,You,Included in Pro,auto,10997,0,145727,2272,158996,Included
2025-08-10T12:39:50.734Z,You,Included in Pro,auto,30057,0,693993,9485,733535,Included
2025-08-10T12:35:12.991Z,You,Included in Pro,auto,4883,0,97563,307,102753,Included
2025-08-10T12:30:50.734Z,You,Included in Pro,auto,25642,0,450178,6664,482484,Included
2025-08-10T10:14:14.879Z,You,Included in Pro,auto,66457,0,249188,10826,326471,Included
2025-08-10T10:05:05.996Z,You,Included in Pro,auto,0,9374,0,19,9393,Included
2025-08-10T10:04:33.020Z,You,Included in Pro,auto,0,9431,0,10,9441,Included
2025-08-10T09:53:10.443Z,You,Included in Pro,auto,51828,0,375251,18281,445360,Included
2025-08-10T09:42:56.017Z,You,Included in Pro,auto,11506,0,196722,2574,210802,Included
2025-08-10T09:41:31.692Z,You,Included in Pro,auto,9797,0,8068,70,17935,Included
2025-08-10T09:39:36.894Z,You,Included in Pro,auto,14328,0,21659,325,36312,Included
2025-08-10T09:17:47.114Z,You,Included in Pro,auto,33591,0,183663,3383,220637,Included
2025-08-10T08:59:36.905Z,You,Included in Pro,auto,0,8557,0,18,8575,Included
2025-08-10T08:59:22.104Z,You,Included in Pro,auto,0,8394,0,18,8412,Included
2025-08-09T16:04:32.676Z,You,Included in Pro,auto,21143,0,348357,7751,377251,Included
2025-08-09T16:00:17.904Z,You,Included in Pro,auto,34424,0,325697,9303,369424,Included
2025-08-09T15:56:56.362Z,You,Included in Pro,auto,6179,0,159875,2471,168525,Included
2025-08-09T15:49:10.427Z,You,Included in Pro,auto,8766,0,118514,663,127943,Included
2025-08-09T15:47:49.683Z,You,Included in Pro,auto,7050,0,77529,1032,85611,Included
2025-08-09T15:45:33.643Z,You,Included in Pro,auto,7207,0,42743,932,50882,Included
2025-08-09T15:42:20.002Z,You,Included in Pro,auto,6910,0,242749,2242,251901,Included
2025-08-09T15:34:26.557Z,You,Included in Pro,auto,5371,0,140106,2360,147837,Included
2025-08-09T15:27:47.070Z,You,Included in Pro,auto,36418,0,290146,7603,334167,Included
2025-08-09T15:21:48.623Z,You,Included in Pro,auto,951,0,35481,540,36972,Included
2025-08-09T15:20:15.044Z,You,Included in Pro,auto,9572,0,49889,439,59900,Included
2025-08-09T15:13:26.371Z,You,Included in Pro,auto,3140,0,46078,2031,51249,Included
2025-08-09T15:11:05.214Z,You,Included in Pro,auto,14693,0,152798,3533,171024,Included
2025-08-09T15:05:13.026Z,You,Included in Pro,auto,16545,0,154336,3110,173991,Included
2025-08-09T14:58:35.879Z,You,Included in Pro,auto,16227,0,108923,1254,126404,Included
2025-08-09T14:47:40.619Z,You,Included in Pro,auto,5887,0,389946,2536,398369,Included
2025-08-09T14:45:51.084Z,You,Included in Pro,auto,5204,0,418022,2589,425815,Included
2025-08-09T14:42:51.037Z,You,Included in Pro,auto,6014,0,326203,2200,334417,Included
2025-08-09T14:36:05.438Z,You,Included in Pro,auto,8452,0,472359,3471,484282,Included
2025-08-09T14:28:02.243Z,You,Included in Pro,auto,38981,0,652757,9608,701346,Included
2025-08-09T13:39:52.952Z,You,Included in Pro,auto,4394,0,91967,1989,98350,Included
2025-08-09T13:37:35.933Z,You,Included in Pro,auto,8534,0,76420,1681,86635,Included
2025-08-09T13:37:12.368Z,You,"Errored, Not Charged",auto,8826,0,20149,203,29178,Included
2025-08-09T12:59:13.215Z,You,Included in Pro,auto,2891,0,16613,877,20381,Included
2025-08-09T12:57:21.804Z,You,Included in Pro,auto,2948,0,15231,1012,19191,Included
2025-08-09T12:54:37.992Z,You,Included in Pro,auto,5714,0,22510,219,28443,Included
2025-08-09T12:51:35.940Z,You,Included in Pro,auto,6505,0,19107,2106,27718,Included
2025-08-09T12:42:03.615Z,You,Included in Pro,auto,66971,0,665097,15455,747523,Included
2025-08-09T12:37:00.326Z,You,Included in Pro,auto,14007,0,98326,1797,114130,Included
2025-08-09T12:32:30.765Z,You,Included in Pro,auto,12672,0,131461,1776,145909,Included
2025-08-09T12:29:14.546Z,You,Included in Pro,auto,12578,0,116202,3432,132212,Included
2025-08-09T12:17:41.275Z,You,Included in Pro,auto,3657,3510,203106,1395,211668,Included
2025-08-09T12:15:06.874Z,You,Included in Pro,auto,15331,0,175979,920,192230,Included
2025-08-09T11:57:51.403Z,You,Included in Pro,auto,35134,0,304054,10144,349332,Included
2025-08-09T11:55:22.316Z,You,Included in Pro,auto,3460,0,28980,453,32893,Included
2025-08-09T11:54:17.963Z,You,Included in Pro,auto,0,7337,0,14,7351,Included
2025-08-09T11:52:59.875Z,You,Included in Pro,auto,1967,0,17886,249,20102,Included
2025-08-09T11:51:09.169Z,You,Included in Pro,auto,3944,0,40862,809,45615,Included
2025-08-09T11:50:52.036Z,You,Included in Pro,auto,0,7717,0,135,7852,Included
2025-08-09T11:50:18.840Z,You,Included in Pro,auto,0,7810,0,102,7912,Included
2025-08-09T11:44:22.669Z,You,Included in Pro,auto,14323,0,246665,3144,264132,Included
2025-08-09T11:44:03.827Z,You,"Errored, Not Charged",auto,20171,0,27746,95,48012,Included
2025-08-09T10:12:00.246Z,You,Included in Pro,auto,0,3913,0,53,3966,Included
2025-08-09T09:53:39.554Z,You,Included in Pro,auto,8830,0,66533,3087,78450,Included
2025-08-09T09:39:07.755Z,You,Included in Pro,auto,13834,0,110499,1013,125346,Included
2025-08-09T08:28:32.960Z,You,Included in Pro,auto,0,1535,0,14,1549,Included
2025-08-09T07:57:34.857Z,You,Included in Pro,auto,0,4635,0,42,4677,Included
2025-08-09T07:57:19.036Z,You,Included in Pro,auto,0,4388,0,43,4431,Included
2025-08-09T06:49:29.391Z,You,Included in Pro,auto,88025,0,689719,8829,786573,Included
2025-08-09T06:42:40.662Z,You,Included in Pro,auto,35808,0,428677,5038,469523,Included
2025-08-09T06:26:49.260Z,You,Included in Pro,auto,14265,0,919353,3446,937064,Included
2025-08-09T06:19:08.731Z,You,Included in Pro,auto,6265,0,182055,1428,189748,Included
2025-08-09T06:03:20.370Z,You,Included in Pro,auto,81868,0,1801573,13244,1896685,Included
2025-08-09T05:55:08.341Z,You,Included in Pro,auto,22684,0,145865,1273,169822,Included
2025-08-09T05:54:52.693Z,You,"Errored, Not Charged",auto,0,0,0,0,0,Included
2025-08-09T05:52:09.625Z,You,Included in Pro,auto,23903,0,125664,1028,150595,Included
2025-08-08T15:48:21.155Z,You,Included in Pro,auto,1115,0,31494,341,32950,Included
2025-08-08T15:47:02.795Z,You,Included in Pro,auto,1767,0,50433,993,53193,Included
2025-08-08T15:45:04.297Z,You,Included in Pro,auto,1127,0,29305,453,30885,Included
2025-08-08T15:33:23.598Z,You,Included in Pro,auto,2398,0,26353,960,29711,Included
2025-08-08T15:21:35.725Z,You,Included in Pro,auto,1653,0,13451,625,15729,Included
2025-08-08T12:54:09.690Z,You,Included in Pro,auto,25965,0,481656,3145,510766,Included
2025-08-08T12:48:09.068Z,You,Included in Pro,auto,36550,0,202747,3378,242675,Included
2025-08-08T12:26:18.561Z,You,Included in Pro,auto,0,5694,0,39,5733,Included
2025-08-08T11:54:21.970Z,You,Included in Pro,auto,8579,0,17374,389,26342,Included
2025-08-08T11:40:50.299Z,You,Included in Pro,auto,10581,0,52619,2207,65407,Included
2025-08-08T11:36:55.852Z,You,Included in Pro,auto,25000,0,67159,1262,93421,Included
2025-08-08T11:32:00.158Z,You,Included in Pro,auto,0,5499,0,40,5539,Included
2025-08-08T11:29:29.655Z,You,Included in Pro,auto,41899,0,42489,3133,87521,Included
2025-08-08T11:15:05.722Z,You,Included in Pro,auto,33599,0,58982,973,93554,Included
2025-08-08T11:10:43.698Z,You,Included in Pro,auto,10576,0,24648,738,35962,Included
2025-08-08T11:06:12.042Z,You,Included in Pro,auto,18666,0,482862,4452,505980,Included
2025-08-08T11:04:30.145Z,You,"Errored, Not Charged",auto,35258,0,204549,2033,241840,Included
2025-08-07T16:26:39.436Z,You,Included in Pro,auto,7056,0,19536,1428,28020,Included
2025-08-07T16:13:56.031Z,You,Included in Pro,auto,66673,0,1254036,6460,1327169,Included
2025-08-07T15:14:10.198Z,You,Included in Pro,auto,26869,0,159298,2099,188266,Included
2025-08-07T14:53:49.031Z,You,Included in Pro,auto,31909,0,491865,6017,529791,Included
2025-08-07T14:50:11.660Z,You,Included in Pro,auto,18306,0,96205,4168,118679,Included
2025-08-07T14:43:30.389Z,You,Included in Pro,auto,12332,0,991815,7013,1011160,Included
2025-08-07T14:32:14.304Z,You,Included in Pro,auto,35856,0,1295943,4757,1336556,Included
2025-08-07T14:17:10.591Z,You,Included in Pro,auto,53343,0,980112,22482,1055937,Included
2025-08-07T08:46:12.703Z,You,Included in Pro,auto,0,1937,0,65,2002,Included
2025-08-07T08:45:32.987Z,You,Included in Pro,auto,0,1861,0,10,1871,Included
2025-08-07T08:45:07.171Z,You,Included in Pro,auto,0,1809,0,10,1819,Included
2025-08-07T08:44:55.782Z,You,Included in Pro,auto,0,1770,0,18,1788,Included
2025-08-07T08:44:20.717Z,You,Included in Pro,auto,0,1692,0,13,1705,Included
2025-08-07T07:15:48.745Z,You,Included in Pro,auto,3669,0,72678,1577,77924,Included
2025-08-06T16:40:36.656Z,You,Included in Pro,auto,37735,0,584949,5726,628410,Included
2025-08-06T16:09:04.636Z,You,Included in Pro,auto,85206,0,2580945,9321,2675472,Included
2025-08-06T15:59:53.885Z,You,Included in Pro,auto,52223,0,1039344,4358,1095925,Included
2025-08-06T15:50:49.613Z,You,Included in Pro,auto,25986,0,266027,3471,295484,Included
2025-08-06T12:51:45.768Z,You,Included in Pro,auto,2173,0,24986,474,27633,Included
2025-08-04T12:51:04.058Z,You,Included in Pro,auto,7664,0,22063,1439,31166,Included
2025-08-04T12:35:26.261Z,You,Included in Pro,auto,0,3022,0,482,3504,Included
2025-08-04T09:31:25.389Z,You,Included in Pro,auto,0,1460,0,9,1469,Included
2025-08-03T04:12:35.256Z,You,Included in Pro,auto,7895,0,33310,1166,42371,Included