Date,User,Kind,Model,Input (w/ Cache Write),Input (w/o Cache Write),Cache Read,Output,Total Tokens,Cost ($)
"2025-08-21T15:33:46.948Z","You","Included in Pro","auto",1514,0,23246,1142,25902,"Included"
"2025-08-21T15:31:21.623Z","You","Included in Pro","auto",7450,0,20665,936,29051,"Included"
"2025-08-21T15:03:50.095Z","You","Included in Pro","auto",0,2139,2048,18,4205,"Included"
"2025-08-21T15:03:34.954Z","You","Included in Pro","auto",0,3817,0,18,3835,"Included"
"2025-08-21T15:03:22.390Z","You","Included in Pro","auto",0,3349,0,18,3367,"Included"
"2025-08-21T15:02:58.490Z","You","Included in Pro","auto",0,2437,0,18,2455,"Included"
"2025-08-21T14:53:32.151Z","You","Included in Pro","auto",4658,0,26002,1136,31796,"Included"
"2025-08-21T14:43:55.358Z","You","Included in Pro","auto",5259,0,18148,1017,24424,"Included"
"2025-08-21T14:36:23.451Z","You","Included in Pro","auto",26381,0,104743,851,131975,"Included"
"2025-08-21T07:09:11.447Z","You","Included in Pro","auto",2502,0,20578,605,23685,"Included"
"2025-08-21T07:00:39.135Z","You","Included in Pro","auto",4548,0,57600,1836,63984,"Included"
"2025-08-21T06:59:03.777Z","You","Included in Pro","auto",4234,0,26094,693,31021,"Included"
"2025-08-20T16:15:01.009Z","You","Included in Pro","auto",6054,0,17420,1335,24809,"Included"
"2025-08-20T15:55:27.996Z","You","Included in Pro","auto",35632,0,812916,4286,852834,"Included"
"2025-08-20T15:21:09.202Z","You","Included in Pro","auto",3781,0,36695,359,40835,"Included"
"2025-08-20T15:18:00.676Z","You","Included in Pro","auto",10380,0,91753,2050,104183,"Included"
"2025-08-20T15:12:12.049Z","You","Errored, Not Charged","auto",37362,0,601940,4397,643699,"Included"
"2025-08-20T15:10:00.566Z","You","Included in Pro","auto",10012,0,99812,1561,111385,"Included"
"2025-08-20T15:05:30.701Z","You","Errored, Not Charged","auto",2537,0,118251,705,121493,"Included"
"2025-08-20T15:01:46.978Z","You","Included in Pro","auto",4417,0,180344,1870,186631,"Included"
"2025-08-20T14:58:33.273Z","You","Included in Pro","auto",19925,0,82794,1277,103996,"Included"
"2025-08-20T14:47:23.066Z","You","Included in Pro","auto",3810,0,27810,554,32174,"Included"
"2025-08-20T14:44:03.094Z","You","Included in Pro","auto",2714,0,318201,484,321399,"Included"
"2025-08-20T14:37:42.819Z","You","Included in Pro","auto",40318,0,278252,2878,321448,"Included"
"2025-08-20T12:38:30.159Z","You","Included in Pro","auto",27074,0,546609,2367,576050,"Included"
"2025-08-20T12:35:21.813Z","You","Included in Pro","auto",21047,0,199024,2385,222456,"Included"
"2025-08-20T12:33:10.272Z","You","Included in Pro","auto",0,3216,0,134,3350,"Included"
"2025-08-20T12:32:36.350Z","You","Included in Pro","auto",0,3121,0,168,3289,"Included"
"2025-08-20T12:25:13.047Z","You","Included in Pro","auto",9508,0,194734,1443,205685,"Included"
"2025-08-20T12:22:48.355Z","You","Included in Pro","auto",16362,0,185394,1634,203390,"Included"
"2025-08-20T12:18:25.638Z","You","Included in Pro","auto",4413,0,30538,1341,36292,"Included"
"2025-08-20T12:17:49.114Z","You","Included in Pro","auto",5357,0,3985,540,9882,"Included"
"2025-08-20T12:08:18.877Z","You","Included in Pro","auto",6582,0,150680,1805,159067,"Included"
"2025-08-20T12:07:08.309Z","You","Included in Pro","auto",2921,0,54691,956,58568,"Included"
"2025-08-20T12:06:37.488Z","You","Included in Pro","auto",278,0,9484,362,10124,"Included"
"2025-08-20T12:04:54.625Z","You","Included in Pro","auto",5483,0,29729,545,35757,"Included"
"2025-08-20T11:54:19.202Z","You","Included in Pro","auto",1342,0,77310,382,79034,"Included"
"2025-08-20T11:52:04.722Z","You","Included in Pro","auto",8822,0,227378,3996,240196,"Included"
"2025-08-20T11:46:20.603Z","You","Included in Pro","auto",25491,0,318716,7968,352175,"Included"
"2025-08-20T11:36:19.202Z","You","Included in Pro","auto",0,5134,0,28,5162,"Included"
"2025-08-20T11:20:26.551Z","You","Included in Pro","auto",611,0,18708,232,19551,"Included"
"2025-08-20T11:19:54.016Z","You","Included in Pro","auto",1753,0,32392,706,34851,"Included"
"2025-08-20T11:15:23.790Z","You","Included in Pro","auto",0,3855,1280,49,5184,"Included"
"2025-08-20T11:13:54.586Z","You","Included in Pro","auto",5339,0,28852,799,34990,"Included"
"2025-08-20T11:06:23.211Z","You","Included in Pro","auto",0,5254,0,329,5583,"Included"
"2025-08-20T11:04:53.441Z","You","Included in Pro","auto",0,4783,0,138,4921,"Included"
"2025-08-20T11:02:44.298Z","You","Included in Pro","auto",0,4958,0,73,5031,"Included"
"2025-08-20T11:02:26.325Z","You","Included in Pro","auto",0,5020,0,34,5054,"Included"
"2025-08-19T15:33:48.857Z","You","Included in Pro","auto",50704,0,156907,4610,212221,"Included"
"2025-08-19T15:09:56.334Z","You","Included in Pro","auto",50994,0,620061,8800,679855,"Included"
"2025-08-19T12:10:38.142Z","You","Included in Pro","auto",3078,0,14693,1713,19484,"Included"
"2025-08-19T12:09:54.635Z","You","Included in Pro","auto",1423,0,22307,911,24641,"Included"
"2025-08-19T12:09:00.174Z","You","Included in Pro","auto",2674,0,34484,1564,38722,"Included"
"2025-08-19T12:06:43.169Z","You","Included in Pro","auto",4399,0,16867,1072,22338,"Included"
"2025-08-19T11:16:46.176Z","You","Included in Pro","auto",2369,0,14401,1211,17981,"Included"
"2025-08-19T11:14:50.824Z","You","Included in Pro","auto",954,0,18355,370,19679,"Included"
"2025-08-19T11:13:17.922Z","You","Included in Pro","auto",1894,0,13425,697,16016,"Included"
"2025-08-19T11:12:29.129Z","You","Included in Pro","auto",0,2237,0,10,2247,"Included"
"2025-08-18T12:06:52.427Z","You","Included in Pro","auto",0,5409,0,105,5514,"Included"
"2025-08-18T12:06:43.614Z","You","Included in Pro","auto",0,5377,0,104,5481,"Included"
"2025-08-18T08:58:18.476Z","You","Included in Pro","auto",0,5360,0,15,5375,"Included"
"2025-08-18T07:05:03.393Z","You","Included in Pro","auto",42554,0,611822,11535,665911,"Included"
"2025-08-18T05:14:08.530Z","You","Included in Pro","auto",2865,0,26125,1035,30025,"Included"
"2025-08-17T14:55:43.838Z","You","Included in Pro","auto",0,2629,0,132,2761,"Included"
"2025-08-17T14:53:13.726Z","You","Included in Pro","auto",0,3741,0,134,3875,"Included"
"2025-08-17T14:53:06.995Z","You","Included in Pro","auto",0,408,3584,93,4085,"Included"
"2025-08-17T14:52:59.358Z","You","Included in Pro","auto",0,613,3072,68,3753,"Included"
"2025-08-17T14:45:07.762Z","You","Included in Pro","auto",0,3542,0,41,3583,"Included"
"2025-08-17T14:41:55.806Z","You","Included in Pro","auto",0,3470,0,65,3535,"Included"
"2025-08-17T12:50:04.924Z","You","Included in Pro","auto",1898,0,13309,736,15943,"Included"
"2025-08-17T12:31:14.966Z","You","Included in Pro","auto",2056,2899,13531,1241,19727,"Included"
"2025-08-17T12:28:41.004Z","You","Included in Pro","auto",2230,0,19359,718,22307,"Included"
"2025-08-17T09:12:56.512Z","You","Included in Pro","auto",0,1012,1024,97,2133,"Included"
"2025-08-17T09:12:47.343Z","You","Included in Pro","auto",0,2096,0,182,2278,"Included"
"2025-08-17T09:12:40.388Z","You","Included in Pro","auto",0,1867,0,76,1943,"Included"
"2025-08-17T09:12:33.331Z","You","Included in Pro","auto",0,2000,0,82,2082,"Included"
"2025-08-17T09:12:23.564Z","You","Included in Pro","auto",0,1972,0,50,2022,"Included"
"2025-08-17T08:37:34.736Z","You","Included in Pro","auto",0,1018,0,14,1032,"Included"
"2025-08-16T14:02:33.327Z","You","Included in Pro","auto",14060,0,104074,1332,119466,"Included"
"2025-08-16T13:14:05.773Z","You","Included in Pro","auto",8263,0,34747,755,43765,"Included"
"2025-08-16T06:21:23.440Z","You","Included in Pro","auto",2807,0,25450,1131,29388,"Included"
"2025-08-15T12:49:50.732Z","You","Included in Pro","auto",4475,0,22463,2351,29289,"Included"
"2025-08-15T12:48:00.216Z","You","Included in Pro","auto",5991,0,13599,1214,20804,"Included"
"2025-08-15T12:46:25.072Z","You","Included in Pro","auto",17572,0,4009,309,21890,"Included"
"2025-08-15T12:44:44.535Z","You","Included in Pro","auto",0,3883,0,11,3894,"Included"
"2025-08-15T12:34:27.491Z","You","Included in Pro","auto",12891,0,217485,5039,235415,"Included"
"2025-08-15T12:33:11.822Z","You","Included in Pro","auto",7644,0,12751,1625,22020,"Included"
"2025-08-15T11:42:43.561Z","You","Included in Pro","auto",15772,0,326136,2133,344041,"Included"
"2025-08-15T10:09:29.830Z","You","Included in Pro","auto",0,1290,0,8,1298,"Included"
"2025-08-14T15:57:08.477Z","You","Included in Pro","auto",0,565,2560,469,3594,"Included"
"2025-08-14T15:56:52.027Z","You","Included in Pro","auto",0,2578,0,453,3031,"Included"
"2025-08-14T15:55:17.760Z","You","Included in Pro","auto",0,2080,0,154,2234,"Included"
"2025-08-14T15:55:05.493Z","You","Included in Pro","auto",0,2172,0,154,2326,"Included"
"2025-08-14T15:54:45.130Z","You","Included in Pro","auto",0,2169,0,152,2321,"Included"
"2025-08-14T15:54:25.255Z","You","Included in Pro","auto",0,3717,0,152,3869,"Included"
"2025-08-14T15:54:02.062Z","You","Included in Pro","auto",0,3714,0,152,3866,"Included"
"2025-08-14T15:53:47.887Z","You","Included in Pro","auto",0,5555,0,152,5707,"Included"
"2025-08-14T15:53:19.020Z","You","Included in Pro","auto",0,2291,0,145,2436,"Included"
"2025-08-14T15:53:01.451Z","You","Included in Pro","auto",0,2189,0,145,2334,"Included"
"2025-08-14T15:52:44.278Z","You","Included in Pro","auto",0,5575,0,153,5728,"Included"
"2025-08-14T15:46:09.525Z","You","Included in Pro","auto",49626,0,287808,3853,341287,"Included"
"2025-08-14T15:24:25.588Z","You","Included in Pro","auto",30954,0,379244,9413,419611,"Included"
"2025-08-14T15:16:34.807Z","You","Included in Pro","auto",0,7532,0,174,7706,"Included"
"2025-08-14T15:15:04.759Z","You","Included in Pro","auto",0,306,7168,118,7592,"Included"
"2025-08-14T15:14:35.771Z","You","Included in Pro","auto",0,7474,0,117,7591,"Included"
"2025-08-14T15:13:09.919Z","You","Included in Pro","auto",0,7726,0,355,8081,"Included"
"2025-08-14T15:12:11.910Z","You","Included in Pro","auto",0,7572,0,219,7791,"Included"
"2025-08-14T15:11:04.272Z","You","Included in Pro","auto",0,7524,0,157,7681,"Included"
"2025-08-14T15:09:31.039Z","You","Included in Pro","auto",0,5685,1792,157,7634,"Included"
"2025-08-14T15:09:01.966Z","You","Included in Pro","auto",0,7473,0,157,7630,"Included"
"2025-08-14T15:08:48.372Z","You","Included in Pro","auto",0,2169,0,157,2326,"Included"
"2025-08-14T15:08:33.936Z","You","Included in Pro","auto",0,2173,0,157,2330,"Included"
"2025-08-14T15:08:16.781Z","You","Included in Pro","auto",0,2175,0,157,2332,"Included"
"2025-08-14T15:07:53.184Z","You","Included in Pro","auto",0,6143,0,213,6356,"Included"
"2025-08-14T15:07:31.853Z","You","Included in Pro","auto",0,5721,0,213,5934,"Included"
"2025-08-14T15:07:10.050Z","You","Included in Pro","auto",0,6593,0,213,6806,"Included"
"2025-08-14T15:06:42.452Z","You","Included in Pro","auto",0,5040,1536,213,6789,"Included"
"2025-08-14T15:06:12.205Z","You","Included in Pro","auto",0,6297,0,36,6333,"Included"
"2025-08-14T15:03:57.291Z","You","Errored, Not Charged","auto",48014,0,331458,5236,384708,"Included"
